https://en.wikipedia.org/wiki/Elon_Musk,633,0,212,10,855
https://en.wikipedia.org/wiki/Steve_Squyres,0,0,0,0,0
https://en.wikipedia.org/wiki/Category:American_corporate_directors,0,0,0,0,0
https://cleantechnica.com/2017/09/07/solar-roof-tile-production-teslas-buffalo-facility-now-running,3,0,27,4,34
https://en.wikipedia.org/wiki/Category:Canadian_technology_company_founders,1,0,0,0,1
https://en.wikipedia.org/wiki/DearMoon_project,3,0,1,0,4
https://en.wikipedia.org/wiki/Virgin_Hyperloop_One,9,0,1,0,10
https://en.wikipedia.org/wiki/Entrepreneur,0,0,0,0,0
https://az.wikipedia.org/wiki/%C4%B0lon_Mask,8,1,17,0,26
https://twitter.com/elonmusk/status/1236029449042198528,0,0,0,0,0
https://en.wikipedia.org/wiki/Vicarious_(Company),1,0,0,0,1
https://en.wikipedia.org/wiki/VentureBeat,0,0,0,0,0
https://en.wikipedia.org/wiki/Tesla_Solar_Roof,43,0,129,11,183
https://en.wikipedia.org/wiki/Nikolay_Zheludev,1,0,0,0,1
https://www.theguardian.com/technology/2018/jul/15/elon-musk-british-diver-thai-cave-rescue-pedo-twitter,23,0,8,0,31
https://www.space.com/spacex-starman-tesla-falcon-heavy-first-orbit-sun.html,5,0,7,0,12
https://en.wikipedia.org/wiki/McGregor,_Texas,0,0,0,0,0
https://en.wikipedia.org/wiki/Michael_Shellenberger,0,0,0,0,0
https://en.wikipedia.org/wiki/Racing_Extinction,1,0,3,0,4
https://twitter.com/elonmusk/status/1018265614295523328,0,0,0,0,0
https://arz.wikipedia.org/wiki/%D8%A7%D9%8A%D9%84%D9%88%D9%86_%D9%85%D8%B3%D9%83,4,0,0,0,4
https://en.wikipedia.org/wiki/PayPal,16,0,4,0,20
https://en.wikipedia.org/wiki/Category:Pages_using_Template:Post-nominals_with_missing_parameters,0,0,0,0,0
https://en.wikipedia.org/wiki/South_African_Defence_Force,0,0,0,0,0
https://web.archive.org/web/20181122215524/https://www.geekwire.com/2018/goodbye-bfr-hello-starship-elon-musk-gives-classic-name-mars-spaceship/,20,0,0,0,20
https://www.bbc.com/news/business-44735412,12,0,4,0,16
https://www.news.com.au/world/asia/handcuffed-drugged-with-ketamine-truth-behind-thai-cave-rescue/news-story/172803c159e20de5cef5dee324266d30,0,0,0,0,0
https://twitter.com/elonmusk/status/1192117194756243457,0,0,0,0,0
https://en.wikipedia.org/wiki/Our_Final_Invention,1,0,0,0,1
https://en.wikipedia.org/wiki/Last.fm,0,0,0,0,0
https://www.mediawiki.org/,0,0,0,0,0
https://en.wikipedia.org/wiki/Tesla_Model_3,47,0,388,5,440
https://en.wikipedia.org/wiki/Template:SpaceX_rocket_launches,0,0,1,0,1
https://en.wikipedia.org/wiki/Commercial_Crew_Program,5,0,1,0,6
https://www.inverse.com/article/39433-elon-musk-sparks-heated-twitter-debate-over-boring-company-s-vision,15,0,0,0,15
https://en.wikipedia.org/wiki/Ooma,0,0,0,0,0
https://www.bbc.co.uk/news/science-environment-35157782,3,0,0,0,3
http://www.teslamotors.com/blog/hyperloop,4,0,7,0,11
https://en.wikipedia.org/wiki/Bachelor%27s_degree,0,0,0,0,0
https://en.wikipedia.org/wiki/Tesla_US_dealership_disputes,5,0,218,1,224
https://en.wikipedia.org/wiki/Democratic_Party_(United_States),1,0,0,0,1
https://en.wikipedia.org/wiki/Category:American_railroad_pioneers,1,0,0,0,1
https://en.wikipedia.org/wiki/New_York_City,0,0,0,0,0
https://en.wikipedia.org/wiki/Heinlein_Prize_for_Advances_in_Space_Commercialization,2,0,0,0,2
https://en.wikipedia.org/wiki/Max_More,1,0,0,0,1
https://en.wikipedia.org/wiki/Nikola_Tesla,0,0,663,0,663
https://web.archive.org/web/20180129131619/http://money.cnn.com/2018/01/28/news/musk-boring-company-flamethrowers/index.html,10,0,1,0,11
https://en.wikipedia.org/wiki/SpaceX_DragonFly,3,0,0,0,3
https://en.wikipedia.org/wiki/Serial_production,0,0,1,0,1
https://en.wikipedia.org/wiki/Banshee_(music_player),0,0,0,0,0
https://en.wikipedia.org/wiki/Charles_Dickens,0,0,0,0,0
http://poskod.my/features/kls-sister-cities/,0,0,0,0,0
https://en.wikipedia.org/wiki/Westinghouse_Electric_(1886),0,0,4,0,4
https://en.wikipedia.org/wiki/Template_talk:GTK,0,0,0,0,0
https://en.wikipedia.org/wiki/T._S._Eliot,0,0,0,0,0
https://en.wikipedia.org/wiki/FLAC,0,0,0,0,0
https://en.wikipedia.org/wiki/Westinghouse_J40,0,0,0,0,0
https://en.wikipedia.org/wiki/Coaching_inn,0,0,0,0,0
https://en.wikipedia.org/wiki/David_Copperfield_(1913_film),0,0,0,0,0
https://en.wikipedia.org/wiki/Eaton_Corporation,0,0,2,0,2
https://en.wikipedia.org/wiki/A_Tale_of_Two_Cities_(1958_film),0,0,0,0,0
http://oxforddictionaries.com/definition/english/Scrooge,-Ebenezer,0,0,0,0,0
https://en.wikipedia.org/wiki/Scrooge_(1935_film),0,0,0,0,0
https://en.wikipedia.org/wiki/GDK,0,0,0,0,0
https://en.wikipedia.org/wiki/Kodi_(software),0,0,0,0,0
https://en.wikipedia.org/wiki/Penny_dreadful,0,0,0,0,0
https://en.wikipedia.org/wiki/Special:BookSources/978-0-415-01761-9,0,0,0,0,0
https://en.wikipedia.org/wiki/The_Pickwick_Papers_(TV_series),0,0,0,0,0
https://en.wikipedia.org/wiki/Higham,_Kent,0,0,0,0,0
https://en.wikipedia.org/wiki/Category:Ghost_story_writers,0,0,0,0,0
https://en.wikipedia.org/wiki/Stephen_Timoshenko,0,0,0,0,0
https://sq.wikipedia.org/wiki/%C3%87arls_Dikens,0,0,0,0,0
https://en.wikipedia.org/wiki/GNOME,0,0,0,0,0
https://en.wikipedia.org/wiki/Category:Software_that_uses_Mono,0,0,0,0,0
https://sr.wikipedia.org/wiki/%D0%A7%D0%B0%D1%80%D0%BB%D1%81_%D0%94%D0%B8%D0%BA%D0%B5%D0%BD%D1%81,0,0,0,0,0
https://te.wikipedia.org/wiki/%E0%B0%9A%E0%B0%BE%E0%B0%B0%E0%B1%8D%E0%B0%B2%E0%B1%86%E0%B0%B8%E0%B1%8D_%E0%B0%A1%E0%B0%BF%E0%B0%95%E0%B1%86%E0%B0%A8%E0%B1%8D%E0%B0%B8%E0%B1%8D,0,0,0,0,0
https://en.wikipedia.org/wiki/George_Westinghouse_Award_(ASEE),0,0,0,0,0
https://en.wikipedia.org/wiki/Special:WhatLinksHere/Banshee_(media_player),0,0,0,0,0
https://en.wikipedia.org/wiki/Gulf_Oil,0,0,0,0,0
https://en.wikipedia.org/wiki/Staplehurst_rail_crash,0,0,0,0,0
https://www.wikidata.org/wiki/Special:EntityPage/Q5686,0,0,0,0,0
https://en.wikipedia.org/wiki/Special:RecentChangesLinked/Banshee_(media_player),0,0,0,0,0
https://en.wikipedia.org/wiki/File:Martin_Chuzzlewit_illus11.jpg,0,0,0,0,0
https://en.wikipedia.org/wiki/Category:Writers_from_London,0,0,0,0,0
https://en.wikipedia.org/wiki/As_Long_as_He_Needs_Me,0,0,0,0,0
https://poskod.my/section/videos/,0,0,0,0,0
https://en.wikipedia.org/wiki/Template_talk:Media_player_software,0,0,0,0,0
https://en.wikipedia.org/wiki/Special:BookSources/978-1-894328-09-8,0,0,0,0,0
https://en.wikipedia.org/wiki/Racism_in_the_work_of_Charles_Dickens,0,0,0,0,0
https://archive.org/details/youthpopularcult00john/page/75,0,0,0,0,0
https://en.wikipedia.org/wiki/Assistive_Technology_Service_Provider_Interface,0,0,0,0,0
https://en.wikipedia.org/wiki/The_New_Criterion,0,0,0,0,0
https://www.wikidata.org/wiki/Q67311526,0,0,0,0,0
https://en.wikipedia.org/wiki/Romantic_racism,0,0,0,0,0
https://en.wikipedia.org/wiki/Dode,_Kent,0,0,0,0,0
https://web.archive.org/web/20120123135059/http://www.iboum.com/artkill/chipsets.php,0,0,0,0,0
https://en.wikipedia.org/wiki/Old_Mother_Riley%27s_Circus,0,0,0,0,0
https://sr.wikipedia.org/wiki/%D0%9F%D1%80%D0%BE%D1%98%D0%B5%D0%BA%D0%B0%D1%82_%D0%93%D0%BD%D0%BE%D0%BC,0,0,0,0,0
https://te.wikipedia.org/wiki/%E0%B0%B5%E0%B0%BF%E0%B0%95%E0%B0%BF%E0%B0%AA%E0%B1%80%E0%B0%A1%E0%B0%BF%E0%B0%AF%E0%B0%BE:%E0%B0%B8%E0%B0%BE%E0%B0%A7%E0%B0%BE%E0%B0%B0%E0%B0%A3_%E0%B0%85%E0%B0%B8%E0%B1%8D%E0%B0%B5%E0%B1%80%E0%B0%95%E0%B0%BE%E0%B0%B0%E0%B0%AE%E0%B1%81,0,0,0,0,0
https://kodi.tv/,0,0,0,0,0
https://en.wikipedia.org/wiki/University_of_Salamanca,0,0,0,0,0
https://en.wikipedia.org/wiki/Sawfish_(window_manager),0,0,0,0,0
https://en.wikipedia.org/wiki/Westinghouse_J46,0,0,0,0,0
https://en.wikipedia.org/wiki/Athanasius_Allanson,0,0,0,0,0
https://en.wikipedia.org/wiki/Westinghouse_J34,0,0,0,0,0
https://en.wikipedia.org/wiki/Category:1865_in_England,0,0,0,0,0
https://en.wikipedia.org/wiki/Westinghouse_J32,0,0,0,0,0
https://en.wikipedia.org/wiki/Westinghouse_J30,0,0,0,0,0
http://xbmc.us/njbetzen/2012/06/15/airtunes-coming-to-xbmc-for-windows-and-why-airplay-is-awesome/,0,0,0,0,0
https://www.wikidata.org/wiki/Property:P866,0,0,0,0,0
https://en.wikipedia.org/wiki/Doctor_at_Sea_(film),0,0,0,0,0
https://en.wikipedia.org/wiki/Romanticism,1,0,0,0,1
https://hy.wikipedia.org/wiki/%D4%B3%D5%86%D5%95%D5%84,0,0,0,0,0
https://archive.is/20131206122800/http://tech2.in.com/video/dell-inspiron-one-2320/278112/tomszNJjmqenwKqGuoe1ppeJvK7JorSXuKi5pbiqqISlh9qr/xbmc-integrated-emulation-with-libretro-retroplayer-wip,0,0,0,0,0
https://en.wikipedia.org/wiki/Patrick_Modiano,0,0,0,0,0
https://en.wikipedia.org/wiki/Udev,0,0,0,0,0
https://en.wikipedia.org/wiki/WebKit,0,0,0,0,0
https://en.wikipedia.org/wiki/Mist_in_the_Valley,0,0,0,0,0
https://archive.org/details/unequalpartnersc00nayd/page/167,0,0,0,0,0
https://en.wikipedia.org/wiki/The_Harvard_Advocate,0,0,0,0,0
http://biblos.usac.edu.gt/library/index.php/Especial:GSMSearchPage,0,0,0,0,0
https://en.wikipedia.org/wiki/Wikipedia:Version_1.0_Editorial_Team/Assessment,0,0,0,0,0
https://sr.wikipedia.org/wiki/%D0%9A%D0%B0%D1%82%D0%B5%D0%B3%D0%BE%D1%80%D0%B8%D1%98%D0%B0:%D0%92%D0%B8%D0%BA%D0%B8%D0%BF%D0%B5%D0%B4%D0%B8%D1%98%D1%81%D0%BA%D0%B8_%D1%87%D0%BB%D0%B0%D0%BD%D1%86%D0%B8_%D1%81%D0%B0_SNAC-ID_%D0%B8%D0%B4%D0%B5%D0%BD%D1%82%D0%B8%D1%84%D0%B8%D0%BA%D0%B0%D1%82%D0%BE%D1%80%D0%B8%D0%BC%D0%B0,0,0,0,0,0
https://www.wikidata.org/wiki/Property:P854,0,0,0,0,0
https://archives.library.wales/index.php/dickens-charles-1812-1870,0,0,0,0,0
https://archives.library.wales/index.php/dickens-charles-1812-1871,0,0,0,0,0
https://web.archive.org/web/20140522090630/https://wiki.gnome.org/Projects/GnomeShell/Terminology,0,0,0,0,0
https://en.wikipedia.org/wiki/Start_menu,0,0,0,0,0
https://www.wikidata.org/wiki/Property:P856,0,0,0,0,0
https://en.wikipedia.org/wiki/Talk:The_New_Criterion,0,0,0,0,0
https://kn.wikipedia.org/wiki/%E0%B2%B0%E0%B3%8A%E0%B2%AE%E0%B3%8D%E0%B2%AF%E0%B2%BE%E0%B2%82%E0%B2%9F%E0%B2%BF%E0%B2%B8%E0%B2%BF%E0%B2%B8%E0%B2%82(%E0%B2%AD%E0%B2%BE%E0%B2%B5%E0%B2%AA%E0%B3%8D%E0%B2%B0%E0%B2%A7%E0%B2%BE%E0%B2%A8%E0%B2%A4%E0%B3%86_%E0%B2%A4%E0%B2%A4%E0%B3%8D%E0%B2%B5,%E0%B2%B8%E0%B2%BF%E0%B2%A6%E0%B3%8D%E0%B2%A6%E0%B2%BE%E0%B2%82%E0%B2%A4),0,0,0,0,0
http://www.worldcat.org/oclc/495731179,0,0,0,0,0
https://zh.wikipedia.org/wiki/Category:%E5%8C%85%E5%90%ABSNAC-ID%E6%A0%87%E8%AF%86%E7%AC%A6%E7%9A%84%E7%BB%B4%E5%9F%BA%E7%99%BE%E7%A7%91%E6%9D%A1%E7%9B%AE,0,0,0,0,0
http://www.worldcat.org/oclc/464266030,0,0,0,0,0
http://www.sand-labs.org/owb,0,0,0,0,0
https://en.wikipedia.org/wiki/Gil_Vicente,0,0,0,0,0
https://snaccooperative.org/vocab_administrator/resources/7357108,0,0,0,0,0
http://www.worldcat.org/oclc/464646578,0,0,0,0,0
https://snaccooperative.org/vocab_administrator/resources/7219456,0,0,0,0,0
https://snaccooperative.org/vocab_administrator/resources/7219455,0,0,0,0,0
https://web.archive.org/web/20120123135059/http://www.iboum.com/pr/icy3010.php,0,0,0,0,0
https://en.wikipedia.org/wiki/File:Fra_Hardanger_Gude.jpg,0,0,0,0,0
https://outreach.wikimedia.org/wiki/Life_of_an_Article,0,0,0,0,0
https://snaccooperative.org/vocab_administrator/resources/7219454,0,0,0,0,0
https://snaccooperative.org/vocab_administrator/resources/7219453,0,0,0,0,0
https://en.wikipedia.org/wiki/Print_Services_for_UNIX,0,0,0,0,0
https://www.wikidata.org/wiki/Q100443,0,0,0,0,0
https://snaccooperative.org/vocab_administrator/resources/7219459,0,0,0,0,0
https://sr.wikipedia.org/wiki/%C4%8Cinua_A%C4%8Debe,0,0,0,0,0
http://www.worldcat.org/oclc/474952115,0,0,0,0,0
https://en.wikipedia.org/wiki/Hans-Dietrich_Genscher,0,0,0,0,0
https://en.wikipedia.org/wiki/F7U_Cutlass,0,0,0,0,0
https://web.archive.org/web/20120123135059/http://www.iboum.com/pr/egs100.php,0,0,0,0,0
http://www.worldcat.org/oclc/270476197,0,0,0,0,0
http://www.worldcat.org/oclc/496118240,0,0,0,0,0
https://snaccooperative.org/vocab_administrator/resources/7219446,0,0,0,0,0
https://pl.wikipedia.org/wiki/Romantyzm,0,0,0,0,0
https://snaccooperative.org/vocab_administrator/resources/7219440,0,0,0,0,0
https://snaccooperative.org/vocab_administrator/resources/7219443,0,0,0,0,0
http://www.worldcat.org/oclc/495803314,0,0,0,0,0
https://snaccooperative.org/vocab_administrator/resources/7219442,0,0,0,0,0
https://bg.wikipedia.org/wiki/%D0%A0%D0%BE%D0%BC%D0%B0%D0%BD%D1%82%D0%B8%D0%B7%D1%8A%D0%BC,0,0,0,0,0
http://www.worldcat.org/oclc/270574631,0,0,0,0,0
https://snaccooperative.org/vocab_administrator/resources/7219448,0,0,0,0,0
https://en.wikipedia.org/wiki/Talk:Mist_in_the_Valley,0,0,0,0,0
https://en.wikipedia.org/wiki/Rob_Messenger,0,0,0,0,0
https://en.wikipedia.org/wiki/Special:BookSources/0-393-97636-X,0,0,0,0,0
http://www.worldcat.org/oclc/465034654,0,0,0,0,0
https://en.wikipedia.org/wiki/William_E._Moerner,0,0,0,0,0
http://www.worldcat.org/oclc/629802564,0,0,0,0,0
https://web.archive.org/web/20051013060413/http://www.britannica.com/eb/article-9083836,0,0,0,0,0
https://en.wikipedia.org/wiki/M._H._Abrams,0,0,0,0,0
https://snaccooperative.org/vocab_administrator/resources/7219434,0,0,0,0,0
https://snaccooperative.org/vocab_administrator/resources/7219433,0,0,0,0,0
https://en.wikipedia.org/wiki/Charles_Lamb,0,0,0,0,0
https://en.wikipedia.org/wiki/Voice_Recorder_(Windows),0,0,0,0,0
https://sr.wikipedia.org/wiki/R_(%D0%BF%D1%80%D0%BE%D0%B3%D1%80%D0%B0%D0%BC%D1%81%D0%BA%D0%B8_%D1%98%D0%B5%D0%B7%D0%B8%D0%BA),0,0,0,0,0
http://www.worldcat.org/oclc/651328063,0,0,0,0,0
https://en.wikipedia.org/wiki/Activity_Monitor_(macOS),0,0,0,0,0
https://snaccooperative.org/vocab_administrator/resources/7219438,0,0,0,0,0
https://en.wikipedia.org/wiki/Brain_Fuck_Scheduler,0,0,0,0,0
https://en.wikipedia.org/wiki/Irydion,0,0,0,0,0
https://en.wikipedia.org/wiki/File:Thomas_Cole_-_The_Voyage_of_Life_Old_Age,_1842_(National_Gallery_of_Art).jpg,0,0,0,0,0
https://en.wikipedia.org/wiki/Mateo_Alem%C3%A1n,0,0,0,0,0
https://en.wikipedia.org/wiki/Gaspar_Sanz,0,0,0,0,0
https://en.wikipedia.org/wiki/MicroB,0,0,0,0,0
http://www.worldcat.org/oclc/464291027,0,0,0,0,0
https://snaccooperative.org/vocab_administrator/resources/7929683,0,0,0,0,0
http://www.worldcat.org/oclc/464646584,0,0,0,0,0
https://ku.wikipedia.org/wiki/Romant%C3%AEzm,0,0,0,0,0
https://kodi.wiki/view/Translation_System,0,0,0,0,0
http://www.worldcat.org/oclc/651328077,0,0,0,0,0
http://www.shanghairanking.com/World-University-Rankings/University-of-Salamanca.html,0,0,0,0,0
https://en.wikipedia.org/wiki/Zadie_Smith,0,0,0,0,0
https://en.wikipedia.org/wiki/DigitalColor_Meter,0,0,0,0,0
https://en.wikipedia.org/wiki/Fjord,0,0,0,0,0
https://en.wikipedia.org/wiki/Mac_OS_X_Lion,0,0,0,0,0
https://en.wikipedia.org/wiki/Francesco_Hayez,0,0,0,0,0
https://snaccooperative.org/vocab_administrator/resources/6696791,0,0,0,0,0
https://archive.is/o/kQ6Tt/tech2.in.com/reviews/graphics-cards/nvidia-geforce-gtx-780-ti-review/921948,0,0,0,0,0
https://www.wikidata.org/wiki/Q26935994,0,0,0,0,0
https://en.wikipedia.org/wiki/Special:BookSources/0-521-27841-4,0,0,0,0,0
https://snaccooperative.org/vocab_administrator/resources/6933039,0,0,0,0,0
https://en.wikipedia.org/wiki/Wuthering_Heights,0,0,0,0,0
https://snaccooperative.org/vocab_administrator/resources/7598151,0,0,0,0,0
https://en.wikipedia.org/wiki/Singapore_Dark_Alternative_Movement,0,0,0,0,0
http://www.worldcat.org/oclc/463333592,0,0,0,0,0
https://web.archive.org/web/20120123135059/http://www.iboum.com/pr/xenta3d.php,0,0,0,0,0
https://en.wikipedia.org/wiki/Facticity,0,0,0,0,0
http://www.worldcat.org/oclc/472670468,0,0,0,0,0
https://snaccooperative.org/vocab_administrator/resources/8315166,0,0,0,0,0
https://en.wikipedia.org/wiki/Special:BookSources/0-7641-5136-3,0,0,0,0,0
https://web.archive.org/web/20120123135059/http://www.iboum.com/pr/eboda500p.php,0,0,0,0,0
http://betanews.com/2015/10/15/microsoft-now-uses-windows-10s-start-menu-to-display-ads/,0,0,0,0,0
https://en.wikipedia.org/wiki/Medway_megaliths,0,0,0,0,0
https://en.wikipedia.org/wiki/Mih%C3%A1ly_V%C3%B6r%C3%B6smarty,0,0,0,0,0
https://snaccooperative.org/vocab_administrator/resources/7118702,0,0,0,0,0
https://en.wikipedia.org/wiki/Theodor_W._Adorno,0,0,0,0,0
https://en.wikipedia.org/wiki/Dutch_Golden_Age_painting,0,0,0,0,0
https://en.wikipedia.org/wiki/Xenomai,0,0,0,0,0
https://en.wikipedia.org/wiki/User:WP_1.0_bot,0,0,0,0,0
https://en.wikipedia.org/wiki/Jill_Adams,0,0,0,0,0
https://en.wikipedia.org/wiki/Echo_(framework),0,0,0,0,0
https://en.wikipedia.org/wiki/Winchester_College,0,0,0,0,0
https://en.wikipedia.org/wiki/Karl_Wilhelm_Friedrich_Schlegel,0,0,0,0,0
https://en.wikipedia.org/wiki/Category:Wikipedia_introduction_cleanup_from_November_2014,0,0,0,0,0
http://www.worldcat.org/oclc/464670229,0,0,0,0,0
https://www.engadget.com/2010/07/28/new-amazon-kindle-announced-139-wifi-only-version-and-189-3g/,0,0,0,0,0
https://en.wikipedia.org/wiki/Linux_kernel_mailing_list,0,0,0,0,0
http://www.glifos.com,0,0,0,0,0
https://web.archive.org/web/20120123135059/http://www.iboum.com/pr/eaget8802.php,0,0,0,0,0
https://sr.wikipedia.org/wiki/%D0%90%D0%BB%D0%B5%D0%BA%D1%81%D0%B0%D0%BD%D0%B4%D0%B5%D1%80_%D0%91%D0%B5%D1%98%D0%BD,0,0,0,0,0
https://fi.wikipedia.org/wiki/Romantiikka,0,0,0,0,0
http://www.worldcat.org/oclc/48623324,0,0,0,0,0
https://web.archive.org/web/20120123135059/http://www.iboum.com/pr/sumlive.php,0,0,0,0,0
https://en.wikipedia.org/wiki/Hierarchy_of_genres,0,0,0,0,0
https://en.wikipedia.org/wiki/Pavel_Kohout,0,0,0,0,0
https://ml.wikipedia.org/wiki/%E0%B4%B5%E0%B5%86%E0%B4%AC%E0%B5%8D%E0%B4%95%E0%B4%BF%E0%B4%B1%E0%B5%8D%E0%B4%B1%E0%B5%8D,0,0,0,0,0
https://nl.wikipedia.org/wiki/Doctor_at_Sea,0,0,0,0,0
http://www.worldcat.org/oclc/44496503,0,0,0,0,0
https://en.wikipedia.org/wiki/Speculative_realism,0,0,0,0,0
http://www.worldcat.org/oclc/466172161,0,0,0,0,0
https://web.archive.org/web/20120123135059/http://www.iboum.com/pr/noonv9.php,0,0,0,0,0
https://snaccooperative.org/vocab_administrator/resources/7173534,0,0,0,0,0
https://web.archive.org/web/20120123135059/http://www.iboum.com/pr/xtelv.php,0,0,0,0,0
https://web.archive.org/web/20120123135059/http://www.iboum.com/pr/wdtvlive11.php,0,0,0,0,0
https://web.archive.org/web/20170127124319/https://webkit.org/blog/189/announcing-squirrelfish/,0,0,0,0,0
https://en.wikipedia.org/wiki/Blisk_(browser),0,0,0,0,0
https://en.wikipedia.org/wiki/Universidad_Cat%C3%B3lica_San_Antonio_de_Murcia,0,0,0,0,0
https://snaccooperative.org/vocab_administrator/resources/7600904,0,0,0,0,0
https://web.archive.org/web/20120123135059/http://www.iboum.com/pr/sage200.php,0,0,0,0,0
https://en.wikipedia.org/wiki/November_Uprising,0,0,0,0,0
https://en.wikipedia.org/wiki/File:John_Martin_-_Sodom_and_Gomorrah.jpg,0,0,0,0,0
https://en.wikipedia.org/wiki/WinHelp,0,0,0,0,0
https://snaccooperative.org/vocab_administrator/resources/7924851,0,0,0,0,0
https://forum.kodi.tv/,0,0,0,0,0
https://en.wikipedia.org/wiki/Cornelius_Castoriadis,0,0,0,0,0
https://en.wikipedia.org/wiki/Isamu_Akasaki,0,0,0,0,0
https://en.wikipedia.org/wiki/Portrait,0,0,0,0,0
https://en.wikipedia.org/wiki/Alexandru_Macedonski,0,0,0,0,0
https://en.wikipedia.org/wiki/Yandex_Browser,0,0,0,0,0
https://sr.wikipedia.org/wiki/%D0%92%D0%B5%D0%B1-%D0%BA%D0%B8%D1%82,0,0,0,0,0
https://en.wikipedia.org/wiki/Hispanic_world,0,0,0,0,0
https://en.wikipedia.org/wiki/Memory_barrier,0,0,0,0,0
http://www.worldcat.org/oclc/496299031,0,0,0,0,0
https://en.wikipedia.org/wiki/Category:1860s_in_England,0,0,0,0,0
https://snaccooperative.org/vocab_administrator/resources/7612902,0,0,0,0,0
https://en.wikipedia.org/wiki/Electronic_body_music,0,0,0,0,0
https://en.wikipedia.org/wiki/Victorian_fashion,0,0,0,0,0
https://webkit.org/,0,0,0,0,0
https://web.archive.org/web/20110423042000/https://lists.webkit.org/pipermail/webkit-dev/2010-April/012235.html,0,0,0,0,0
http://www.worldcat.org/oclc/463628888,0,0,0,0,0
http://www.worldcat.org/oclc/464269939,0,0,0,0,0
https://en.wikipedia.org/wiki/Romantic_nationalism,0,0,0,0,0
https://en.wikipedia.org/wiki/The_Linux_Programming_Interface,0,0,0,0,0
https://en.wikipedia.org/wiki/Louis_Althusser,0,0,0,0,0
http://www.worldcat.org/oclc/496304159,0,0,0,0,0
https://sr.wikipedia.org/wiki/Bab,0,0,0,0,0
https://en.wikipedia.org/wiki/List_of_oldest_universities_in_continuous_operation,0,0,0,0,0
http://www.worldcat.org/oclc/270613011,0,0,0,0,0
https://webkit.org/blog/140/html5-media-support/,0,0,0,0,0
https://he.wikipedia.org/wiki/%D7%A8%D7%95%D7%9E%D7%A0%D7%98%D7%99%D7%A7%D7%94,0,0,0,0,0
https://en.wikipedia.org/wiki/Software_architecture,0,0,0,0,0
https://en.wikipedia.org/wiki/Lumous_Gothic_Festival,0,0,0,0,0
https://en.wikipedia.org/wiki/System_Integrity_Protection,0,0,0,0,0
https://en.wikipedia.org/wiki/Leszek_Ko%C5%82akowski,0,0,0,0,0
https://en.wikipedia.org/wiki/Timberwolf_(web_browser),0,0,0,0,0
https://en.wikipedia.org/wiki/Heidelberg_School,0,0,0,0,0
https://en.wikipedia.org/wiki/Template_talk:1920s-UK-film-stub,0,0,0,0,0
https://en.wikipedia.org/wiki/Heinrich_von_Kleist,0,0,0,0,0
https://en.wikipedia.org/wiki/Template:Web_browsers,0,0,0,0,0
https://en.wikipedia.org/wiki/Hubert_Dreyfus,0,0,0,0,0
https://en.wikipedia.org/wiki/Milan_Kundera,0,0,0,0,0
https://en.wikipedia.org/wiki/Inotify,0,0,0,0,0
https://snaccooperative.org/vocab_administrator/resources/7600915,0,0,0,0,0
https://en.wikipedia.org/wiki/Terminal_(macOS),0,0,0,0,0
https://archive.is/o/kQ6Tt/tech2.in.com/gaming,0,0,0,0,0
https://snaccooperative.org/vocab_administrator/resources/7255161,0,0,0,0,0
https://web.archive.org/web/20120123135059/http://www.iboum.com/pr/hornetshow.php,0,0,0,0,0
https://en.wikipedia.org/wiki/University_of_Cantabria,0,0,0,0,0
http://www.worldcat.org/oclc/63217181,0,0,0,0,0
https://en.wikipedia.org/wiki/Carl_Czerny,0,0,0,0,0
https://en.wikipedia.org/wiki/Stickies_(Apple),0,0,0,0,0
https://en.wikipedia.org/wiki/Game_Center,0,0,0,0,0
https://en.wikipedia.org/wiki/Peter_Huchel,0,0,0,0,0
https://en.wikipedia.org/wiki/University_of_Lleida,0,0,0,0,0
http://www.worldcat.org/oclc/49374891,0,0,0,0,0
https://en.wikipedia.org/wiki/Anton_Delvig,0,0,0,0,0
https://en.wikipedia.org/wiki/Outlook_Express,0,0,0,0,0
https://en.wikipedia.org/wiki/Karl_Jaspers,0,0,0,0,0
https://snaccooperative.org/vocab_administrator/resources/7838387,0,0,0,0,0
https://snaccooperative.org/vocab_administrator/resources/7838386,0,0,0,0,0
http://www.worldcat.org/oclc/270531533,0,0,0,0,0
https://en.wikipedia.org/wiki/Maxthon,0,0,0,0,0
https://snaccooperative.org/vocab_administrator/resources/7838383,0,0,0,0,0
https://snaccooperative.org/vocab_administrator/resources/7838382,0,0,0,0,0
https://en.wikipedia.org/wiki/Index_of_continental_philosophy_articles,0,0,0,0,0
https://snaccooperative.org/vocab_administrator/resources/7582592,0,0,0,0,0
https://en.wikipedia.org/wiki/Music_(software),0,0,0,0,0
https://en.wikipedia.org/wiki/Avant_Browser,0,0,0,0,0
https://www.wikidata.org/wiki/Q101727,0,0,0,0,0
https://en.wikipedia.org/wiki/The_Last_Day_of_Pompeii,0,0,0,0,0
https://web.archive.org/web/20110301192936/http://www.visionmobile.com/blog/2010/10/smart-feature-phones-the-unbalanced-equation-100-million-club-series/,0,0,0,0,0
https://snaccooperative.org/vocab_administrator/resources/7600936,0,0,0,0,0
https://nl.wikipedia.org/wiki/Startmenu,0,0,0,0,0
http://www.worldcat.org/oclc/488753820,0,0,0,0,0
https://en.wikipedia.org/wiki/Der_Sandmann,0,0,0,0,0
http://www.worldcat.org/oclc/58661494,0,0,0,0,0
https://snaccooperative.org/vocab_administrator/resources/7611618,0,0,0,0,0
https://en.wikipedia.org/wiki/Aerospace_Museum_of_California,0,0,0,0,0
https://en.wikipedia.org/wiki/Andr%C3%A9_Gr%C3%A9try,0,0,0,0,0
https://www.wikidata.org/wiki/Q17142840,0,0,0,0,0
https://snaccooperative.org/vocab_administrator/resources/7600931,0,0,0,0,0
https://en.wikipedia.org/wiki/Shockwave_(Jet_Truck),0,0,0,0,0
https://en.wikipedia.org/wiki/.NET_Framework,0,0,0,0,0
https://sr.wikipedia.org/wiki/%D0%A0%D0%B0%D0%B7%D0%B3%D0%BE%D0%B2%D0%BE%D1%80_%D0%BE_%D1%88%D0%B0%D0%B1%D0%BB%D0%BE%D0%BD%D1%83:GNU,0,0,0,0,0
https://web.archive.org/web/20071013150411/http://dot.kde.org/1121021917/,0,0,0,0,0
https://war.wikipedia.org/wiki/Unibersidad_han_Salamanca,0,0,0,0,0
https://snaccooperative.org/vocab_administrator/resources/7965386,0,0,0,0,0
http://www.worldcat.org/oclc/26598462,0,0,0,0,0
https://sr.wikipedia.org/wiki/%D0%90%D1%85%D0%BC%D0%B0%D0%B4_%D0%A8%D0%B0%D1%85_%D0%94%D1%83%D1%80%D0%B0%D0%BD%D0%B8,0,0,0,0,0
http://www.worldcat.org/oclc/468816517,0,0,0,0,0
https://en.wikipedia.org/wiki/Rachel_Wetzsteon,0,0,0,0,0
https://en.wikipedia.org/wiki/Special:BookSources/978-0-415-08378-2,0,0,0,0,0
https://snaccooperative.org/vocab_administrator/resources/7881180,0,0,0,0,0
https://snaccooperative.org/vocab_administrator/resources/7612918,0,0,0,0,0
https://snaccooperative.org/vocab_administrator/resources/7131751,0,0,0,0,0
https://en.wikipedia.org/wiki/Alarms_%26_Clock,0,0,0,0,0
https://en.wikipedia.org/wiki/Apple_Mail,0,0,0,0,0
https://web.archive.org/web/20120123135059/http://www.iboum.com/pr/eagetx6.php,0,0,0,0,0
https://en.wikipedia.org/wiki/Windows_shell,0,0,0,0,0
https://sr.wikipedia.org/wiki/%D0%91%D1%80%D0%B8%D0%B6%D0%B8%D1%82_%D0%91%D0%B0%D1%80%D0%B4%D0%BE,0,0,0,0,0
https://en.wikipedia.org/wiki/List_of_gothic_festivals,0,0,0,0,0
https://en.wikipedia.org/wiki/Friedrich_Wilhelm_Joseph_von_Schelling,0,0,0,0,0
http://www.worldcat.org/oclc/464640452,0,0,0,0,0
https://en.wikipedia.org/wiki/Donald_Jay_Grout,0,0,0,0,0
https://te.wikipedia.org/wiki/%E0%B0%B5%E0%B0%BF%E0%B0%95%E0%B1%80%E0%B0%AA%E0%B1%80%E0%B0%A1%E0%B0%BF%E0%B0%AF%E0%B0%BE:Text_of_Creative_Commons_Attribution-ShareAlike_3.0_Unported_License,0,0,0,0,0
https://snaccooperative.org/vocab_administrator/resources/7184247,0,0,0,0,0
https://en.wikipedia.org/wiki/Hotplug,0,0,0,0,0
https://en.wikipedia.org/wiki/Chris_Gerolmo,0,0,0,0,0
https://en.wikipedia.org/wiki/Menuconfig,0,0,0,0,0
http://www.worldcat.org/oclc/606938741,0,0,0,0,0
https://en.wikipedia.org/wiki/Old_Mother_Riley,0,0,0,0,0
https://en.wikipedia.org/wiki/J%C3%B8rgen_Moe,0,0,0,0,0
http://www.worldcat.org/oclc/70213959,0,0,0,0,0
https://en.wikipedia.org/wiki/Autonomous_University_of_Barcelona,0,0,0,0,0
https://en.wikipedia.org/wiki/Neo-Kantianism,0,0,0,0,0
http://www.worldcat.org/oclc/474930793,0,0,0,0,0
https://web.archive.org/web/20120123135059/http://www.iboum.com/pr/fansmhub.php,0,0,0,0,0
https://webkit.org,0,0,0,0,0
https://en.wikipedia.org/wiki/Taylor_%26_Francis,0,0,0,0,0
https://sr.wikipedia.org/wiki/%D0%90%D0%BD%D0%B4%D1%80%D0%B5%D0%B0%D1%81_%D0%90%D1%85%D0%B5%D0%BD%D0%B1%D0%B0%D1%85,0,0,0,0,0
https://web.archive.org/web/20120123135059/http://www.iboum.com/pr/playon-plus.php,0,0,0,0,0
https://en.wikipedia.org/wiki/Penton_(company),0,0,0,0,0
https://en.wikipedia.org/wiki/Saint,0,0,0,0,0
https://en.wikipedia.org/wiki/Friedrich_Wilhelm_Joseph_Schelling,0,0,0,0,0
https://en.wikipedia.org/wiki/Category:1941_comedy_films,0,0,0,0,0
https://en.wikipedia.org/wiki/Imperial_Russian_Army,0,0,0,0,0
https://snaccooperative.org/vocab_administrator/resources/7582671,0,0,0,0,0
https://en.wikipedia.org/wiki/Vegetarianism_and_Romanticism,0,0,0,0,0
https://snaccooperative.org/vocab_administrator/resources/7567034,0,0,0,0,0
https://archive.org/web/,0,0,0,0,0
https://en.wikipedia.org/wiki/Batcave_(club),0,0,0,0,0
https://archive.org/details/americana,0,0,0,0,0
https://en.wikipedia.org/wiki/Active_Directory_Rights_Management_Services,0,0,0,0,0
https://snaccooperative.org/vocab_administrator/resources/7580010,0,0,0,0,0
https://en.wikipedia.org/wiki/Angst,0,0,0,0,0
https://snaccooperative.org/vocab_administrator/resources/7582666,0,0,0,0,0
https://en.wikipedia.org/wiki/Joseph_Anton_Koch,0,0,0,0,0
https://archive.is/o/kQ6Tt/www.moneycontrol.com/,0,0,0,0,0
https://snaccooperative.org/vocab_administrator/resources/7580009,0,0,0,0,0
https://en.wikipedia.org/wiki/Richard_Bulliet,0,0,0,0,0
https://en.wikipedia.org/wiki/SalamWeb,0,0,0,0,0
https://openlibrary.org/works/OL2756234W,0,0,0,0,0
https://en.wikipedia.org/wiki/Johan_Christian_Dahl,0,0,0,0,0
https://en.wikipedia.org/wiki/University_of_Murcia,0,0,0,0,0
http://www.worldcat.org/oclc/225136858,0,0,0,0,0
https://www.wikidata.org/wiki/Property:P2868,0,0,0,0,0
http://www.worldcat.org/oclc/625900062,0,0,0,0,0
https://en.wikipedia.org/wiki/Category:Unix_file_system-related_software,0,0,0,0,0
https://snaccooperative.org/vocab_administrator/resources/7582654,0,0,0,0,0
http://www.worldcat.org/oclc/31528497,0,0,0,0,0
https://snaccooperative.org/vocab_administrator/resources/7796037,0,0,0,0,0
https://web.archive.org/web/20120123135059/http://www.iboum.com/pr/fan2300.php,0,0,0,0,0
https://en.wikipedia.org/wiki/Google_Web_Toolkit,0,0,0,0,0
https://en.wikipedia.org/wiki/MOS:IMAGERELEVANCE,0,0,0,0,0
https://en.wikipedia.org/wiki/Line_Mode_Browser,0,0,0,0,0
https://snaccooperative.org/vocab_administrator/resources/7567016,0,0,0,0,0
https://www.wikidata.org/wiki/Property:P2875,0,0,0,0,0
https://en.wikipedia.org/wiki/George_Santayana,0,0,0,0,0
http://www.worldcat.org/oclc/489099983,0,0,0,0,0
https://en.wikipedia.org/wiki/Tate,0,0,0,0,0
https://en.wikipedia.org/wiki/Category:18th_century_in_art,0,0,0,0,0
https://en.wikipedia.org/wiki/Incoherents,0,0,0,0,0
http://www.worldcat.org/oclc/489476456,0,0,0,0,0
http://www.worldcat.org/oclc/122540553,0,0,0,0,0
http://www.worldcat.org/oclc/625900064,0,0,0,0,0
https://snaccooperative.org/vocab_administrator/resources/7582650,0,0,0,0,0
https://snaccooperative.org/vocab_administrator/resources/7583976,0,0,0,0,0
https://archive.is/o/kQ6Tt/tech2.in.com/laptops,0,0,0,0,0
https://web.archive.org/web/20120123135059/http://www.iboum.com/RSS/rssfeed.rss,0
https://en.wikipedia.org/wiki/Will_to_power,0,0,0,0,0
https://archive.org/details/tabletalksamuel01morlgoog,0,0,0,0,0
https://en.wikipedia.org/wiki/File:Symbol_c_class.svg,0,0,0,0,0
https://en.wikipedia.org/wiki/Reductionism,0,0,0,0,0
https://en.wikipedia.org/wiki/File_Allocation_Table,0,0,0,0,0
https://zh-min-nan.wikipedia.org/wiki/L%C3%B4-m%C3%A1n-ch%C3%BA-g%C4%AB,0,0,0,0,0
http://www.worldcat.org/oclc/464666988,0,0,0,0,0
https://en.wikipedia.org/wiki/Goethe%27s_Faust,0,0,0,0,0
https://en.wikipedia.org/wiki/Precisionism,0,0,0,0,0
https://en.wikipedia.org/wiki/Pale_Moon_(web_browser),0,0,0,0,0
http://www.worldcat.org/oclc/464640372,0,0,0,0,0
https://en.wikipedia.org/wiki/Yitzhak_Rabin,0,0,0,0,0
https://en.wikipedia.org/wiki/File:Westinghouse_J30_NAN8-47.jpg,0,0,0,0,0
https://en.wikipedia.org/wiki/Windows_Spotlight,0,0,0,0,0
https://en.wikipedia.org/wiki/Late_modernism,0,0,0,0,0
https://snaccooperative.org/vocab_administrator/resources/7154380,0,0,0,0,0
https://www.wikidata.org/wiki/Property:P2888,0,0,0,0,0
http://www.worldcat.org/oclc/647899622,0,0,0,0,0
http://www.worldcat.org/oclc/475725648,0,0,0,0,0
https://www.wikidata.org/wiki/Property:P1552,0,0,0,0,0
http://www.worldcat.org/oclc/463292483,0,0,0,0,0
https://en.wikipedia.org/wiki/Category:Application_programming_interfaces,0,0,0,0,0
http://www.worldcat.org/oclc/489084005,0,0,0,0,0
http://www.worldcat.org/oclc/270958646,0,0,0,0,0
http://www.worldcat.org/oclc/270923942,0,0,0,0,0
http://www.worldcat.org/oclc/476900619,0,0,0,0,0
https://en.wikipedia.org/wiki/Louis_Begley,0,0,0,0,0
https://archive.is/o/kQ6Tt/tech2.in.com/desktops,0,0,0,0,0
http://www.worldcat.org/oclc/269541299,0,0,0,0,0
https://en.wikipedia.org/wiki/Apollonian_and_Dionysian,0,0,0,0,0
https://snaccooperative.org/vocab_administrator/resources/6690578,0,0,0,0,0
https://web.archive.org/web/20120123135059/http://www.iboum.com/pr/hdx-bone.php,0,0,0,0,0
http://www.worldcat.org/oclc/286913561,0,0,0,0,0
http://www.worldcat.org/oclc/81003830,0,0,0,0,0
https://web.archive.org/web/20120123135059/http://www.iboum.com/pr/emin.php,0,0,0,0,0
https://www.mediawiki.org/wiki/Special:MyLanguage/Help:Categories,0,0,0,0,0
https://bn.wikipedia.org/wiki/%E0%A6%B0%E0%A7%8B%E0%A6%AE%E0%A6%BE%E0%A6%A8%E0%A7%8D%E0%A6%9F%E0%A6%BF%E0%A6%95%E0%A6%A4%E0%A6%BE,0,0,0,0,0
https://www.wikidata.org/wiki/Property:P1581,0,0,0,0,0
http://www.worldcat.org/oclc/270608597,0,0,0,0,0
https://en.wikipedia.org/wiki/File:William_Blake_-_Songs_of_Innocence_and_of_Experience,_Plate_35,_%22The_Little_Girl_Found%22_(Bentley_36)_-_Google_Art_Project_(cropped).jpg,0,0,0,0,0
http://www.worldcat.org/oclc/465447146,0,0,0,0,0
https://snaccooperative.org/vocab_administrator/resources/7532360,0,0,0,0,0
https://en.wikipedia.org/wiki/Esme_Hubbard,0,0,0,0,0
https://en.wikipedia.org/wiki/Valencian_Community,0,0,0,0,0
https://web.archive.org/web/20120123135059/http://www.iboum.com/pr/arg335.php,0,0,0,0,0
https://en.wikipedia.org/wiki/Uncas,0,0,0,0,0
https://en.wikipedia.org/wiki/Internet_Explorer,0,0,0,0,0
https://snaccooperative.org/vocab_administrator/resources/7582616,0,0,0,0,0
https://snaccooperative.org/vocab_administrator/resources/7582614,0,0,0,0,0
http://newbiedoc.sourceforge.net/tutorials/kernel-pkg/config-kernel-pkg.html.en,0,0,0,0,0
https://en.wikipedia.org/wiki/Italian_and_Swiss_expedition,0,0,0,0,0
https://web.archive.org/web/20120123050939/http://www.iboum.com/pr/dathdx2.php,0,0,0,0,0
https://web.archive.org/web/20120123160602/http://www.iboum.com/pr/astone110.php,0,0,0,0,0
https://en.wikipedia.org/wiki/Category:Foreign_Ministers_of_Germany,0,0,0,0,0
https://zh.wikipedia.org/wiki/%E8%B4%9D%E4%BC%A6%E5%B0%BC%E6%96%AF%C2%B7%E9%98%BF%E5%8D%9A%E7%89%B9,0,0,0,0,0
https://nla.gov.au/anbd.aut-an35026562,0,0,0,0,0
https://en.wikipedia.org/wiki/Brigitte_Baumeister,0,0,0,0,0
https://ja.wikipedia.org/wiki/%E3%83%AB%E3%82%A4%E3%83%BB%E3%82%A2%E3%83%AB%E3%83%81%E3%83%A5%E3%82%BB%E3%83%BC%E3%83%AB,0,0,0,0,0
https://en.wikipedia.org/wiki/Langdale_axe_industry,0,0,0,0,0
https://en.wikipedia.org/wiki/Amiga_3000UX,0,0,0,0,0
http://www.shanghairanking.com/Chinese_Universities_Rankings/Teaching-and-Learning-Ranking-2015.html,0,0,0,0,0
https://en.wikipedia.org/wiki/Zsuzsa_B%C3%A1nk,0,0,0,0,0
https://www.worldcat.org/title/autograph-letter-signed-hanover-villa-london-to-charles-dickens-1856-june-7/oclc/\"http:\/\/schema.org\/CreativeWork\",0,0,0,0,0
https://www.worldcat.org/title/autograph-letter-signed-london-to-miss-eleanor-tennent-1869-mar-13/oclc/\"http:\/\/worldcat.org\/entity\/work\/id\/503706048\",0,0,0,0,0
https://web.archive.org/web/20120123050939/http://www.iboum.com/pr/egr200s.php,0,0,0,0,0
https://web.archive.org/web/20120123160602/http://www.iboum.com/pr/PHA200.php,0,0,0,0,0
https://en.wikipedia.org/wiki/Dulce_Domum,0,0,0,0,0
https://web.archive.org/web/20120123171844/http://www.iboum.com/pr/novad83.php,0,0,0,0,0
https://en.wikipedia.org/wiki/Anthropology,0,0,0,0,0
https://en.wikipedia.org/wiki/Anton_Chekhov,0,0,0,0,0
https://web.archive.org/web/20120123033746/http://www.iboum.com/pr/sarot6b.php,0,0,0,0,0
http://www.ibiblio.org/eldritch/ac/jr/index.htm,0,0,0,0,0
https://en.wikipedia.org/wiki/Hans-Peter_Uhl,0,0,0,0,0
https://web.archive.org/web/20120123185152/http://www.iboum.com/pr/eageth5.php,0,0,0,0,0
https://web.archive.org/web/20120123124815/http://www.futeko.com/navpage/media-players.php,0,0,0,0,0
https://zh.wikipedia.org/wiki/%E5%AE%89%E5%BE%B7%E7%83%88%C2%B7%E6%9F%AF%E7%89%B9%E8%8C%B2,0,0,0,0,0
https://web.archive.org/web/20120123033746/http://www.iboum.com/pr/lenlhd80.php,0,0,0,0,0
https://en.wikipedia.org/wiki/Moral_economy,0,0,0,0,0
https://web.archive.org/web/20120123035335/http://www.iboum.com/pr/freexs.php,0,0,0,0,0
https://en.wikipedia.org/wiki/Blitter_(OCS),0,0,0,0,0
https://en.wikipedia.org/wiki/Hortense_Powdermaker,0,0,0,0,0
https://web.archive.org/web/20120123180618/http://www.iboum.com/pr/med85015.php,0,0,0,0,0
https://www.wikidata.org/wiki/Special:EntityPage/Q5685,0,0,0,0,0
https://web.archive.org/web/20120123185152/http://www.iboum.com/pr/med5x2.php,0,0,0,0,0
https://ja.wikipedia.org/wiki/Category:%E3%83%9E%E3%83%AB%E3%82%AF%E3%82%B9%E4%B8%BB%E7%BE%A9%E7%90%86%E8%AB%96%E5%AE%B6,0,0,0,0,0
https://en.wikipedia.org/wiki/Category:Johannes_Gutenberg_University_Mainz_alumni,0,0,0,0,0
https://arz.wikipedia.org/wiki/%D8%A8%D8%B1%D9%8A%D8%AC%D9%8A%D8%AA_%D8%A8%D8%A7%D9%88%D9%85%D9%8A%D8%B3%D8%AA%D9%8A%D8%B1,0,0,0,0,0
https://en.wikipedia.org/wiki/Anette_Kramme,0,0,0,0,0
https://ja.wikipedia.org/wiki/%E5%BC%81%E8%A8%BC%E6%B3%95,0,0,0,0,0
https://ja.wikipedia.org/wiki/%E3%83%99%E3%83%AC%E3%83%8B%E3%82%B9%E3%83%BB%E3%82%A2%E3%83%9C%E3%83%83%E3%83%88,0,0,0,0,0
https://web.archive.org/web/20120123124815/http://www.iboum.com/pr/iconx100.php,0,0,0,0,0
https://ja.wikipedia.org/wiki/%E3%82%AB%E3%83%88%E3%83%AA%E3%83%83%E3%82%AF%E6%95%99%E4%BC%9A,0,0,0,0,0
https://web.archive.org/web/20120123033746/http://www.iboum.com/pr/wdtv-elephant-play.php,0,0,0,0,0
https://web.archive.org/web/20120123185152/http://www.iboum.com/pr/xtreamsid.php,0,0,0,0,0
https://web.archive.org/web/20120123180618/http://www.iboum.com/pr/PH200.php,0,0,0,0,0
https://ja.wikipedia.org/wiki/%E3%82%AB%E3%83%BC%E3%83%AB%E3%83%BB%E3%83%9E%E3%83%AB%E3%82%AF%E3%82%B9,0,0,0,0,0
https://en.wikipedia.org/wiki/Omaha_kinship,0,0,0,0,0
https://en.wikipedia.org/wiki/Template:Song-stub,0,0,0,0,0
https://en.wikipedia.org/wiki/Evolutionary_anthropology,0,0,0,0,0
https://en.wikipedia.org/wiki/Carsten_Tr%C3%A4ger,0,0,0,0,0
https://en.wikipedia.org/wiki/Hans_Dieter_Betz,0,0,0,0,0
https://ja.wikipedia.org/wiki/%E5%8D%81%E5%AD%97%E8%BB%8D,0,0,0,0,0
https://web.archive.org/web/20120123033949/http://www.iboum.com/pr/ast300t.php,0,0,0,0,0
https://web.archive.org/web/20120123030335/http://www.iboum.com/pr/xtreamsid2.php,0,0,0,0,0
https://ja.wikipedia.org/wiki/%E3%83%8F%E3%83%BC%E3%82%B0,0,0,0,0,0
https://en.wikipedia.org/wiki/Christian_Egenolff,0,0,0,0,0
https://web.archive.org/web/20120127063654/http://www.iboum.com/pr/mediavx.php,0,0,0,0,0
https://ja.wikipedia.org/wiki/%E3%82%AA%E3%83%8E%E3%83%AC%E3%83%BB%E3%83%89%E3%83%BB%E3%83%90%E3%83%AB%E3%82%B6%E3%83%83%E3%82%AF,0,0,0,0,0
https://ja.wikipedia.org/wiki/%E3%83%9E%E3%83%AB%E3%82%BF,0,0,0,0,0
https://ja.wikipedia.org/wiki/%E5%87%BA%E6%9C%AD,0,0,0,0,0
https://en.wikipedia.org/wiki/Ingbert_Liebing,0,0,0,0,0
https://web.archive.org/web/20120123032517/http://www.iboum.com/pr/diamond-mp-1000.php,0,0,0,0,0
https://web.archive.org/web/20120123051440/http://www.iboum.com/pr/sumcyc2.php,0,0,0,0,0
https://web.archive.org/web/20120123030335/http://www.iboum.com/pr/dune53.php,0,0,0,0,0
https://web.archive.org/web/20120123152103/http://www.iboum.com/pr/mediavx.php,0,0,0,0,0
https://km.wikipedia.org/wiki/%E1%9E%96%E1%9F%92%E1%9E%9A%E1%9F%87%E1%9E%9F%E1%9E%A0%E1%9E%82%E1%9E%98%E1%9E%93%E1%9F%8D%E1%9E%80%E1%9E%B6%E1%9E%8F%E1%9E%BC%E1%9E%9B%E1%9E%B7%E1%9E%80,0,0,0,0,0
https://ja.wikipedia.org/wiki/%E3%83%81%E3%83%A3%E3%83%BC%E3%83%86%E3%82%A3%E3%82%B9%E3%83%88%E9%81%8B%E5%8B%95,0,0,0,0,0
https://web.archive.org/web/20120127063654/http://www.iboum.com/pr/fan2750.php,0,0,0,0,0
https://web.archive.org/web/20120123032517/http://www.statcounter.com/wordpress.org/,0,0,0,0,0
https://de.wikipedia.org/wiki/Preu%C3%9Fische_Armee,7,0,0,0,7
http://matsubara-cath.chu.jp/extra/qa1/,0,0,0,0,0
https://ja.wikipedia.org/wiki/%E5%9C%B0%E5%8B%95%E8%AA%AC,0,0,0,0,0
https://web.archive.org/web/20120123033949/http://www.iboum.com/pr/em200.php,0,0,0,0,0
https://web.archive.org/web/20120123151820/http://www.iboum.com/pr/fantech-fhdl.php,0,0,0,0,0
https://ja.wikipedia.org/wiki/%E5%A9%9A%E5%A7%BB%E3%81%AE%E7%A7%98%E8%B7%A1,0,0,0,0,0
https://web.archive.org/web/20120123152103/http://www.iboum.com/pr/olevia530.php,0,0,0,0,0
https://web.archive.org/web/20120123041356/http://www.iboum.com/pr/WDTV2-LIVE-PLUS.php,0,0,0,0,0
https://en.wikipedia.org/wiki/Marc_Bernhard,0,0,0,0,0
https://web.archive.org/web/20120127063654/http://www.iboum.com/pr/ideri9.php,0,0,0,0,0
https://web.archive.org/web/20120123033949/http://www.iboum.com/pr/med85015.php,0,0,0,0,0
https://uk.wikipedia.org/wiki/%D0%94%D1%96%D0%B0%D0%BB%D0%B5%D0%BA%D1%82%D0%B8%D0%BA%D0%B0,0,0,0,0,0
http://www.ibiblio.org/eldritch/ac/chekhov.html,0,0,0,0,0
https://web.archive.org/web/20120123180404/http://www.iboum.com/pr/ellion-labo.php,0,0,0,0,0
https://en.wikipedia.org/wiki/Category:Alumni_by_university_or_college_in_Germany,0,0,0,0,0
http://www.dw.de/european-politicians-listed-as-possible-targets-by-norwegian-gunman/a-15264111,0,0,0,0,0
https://web.archive.org/web/20120123051440/http://www.iboum.com/pr/dune301.php,0,0,0,0,0
https://en.wikipedia.org/wiki/Dinkha_IV,0,0,0,0,0
https://ja.wikipedia.org/wiki/%E5%8D%97%E5%B1%B1%E5%A4%A7%E5%AD%A6,0,0,0,0,0
https://web.archive.org/web/20120123051440/http://www.iboum.com/pr/iomegdx.php,0,0,0,0,0
https://web.archive.org/web/20120123152103/http://www.iboum.com/pr/nad446.php,0,0,0,0,0
https://ja.wikipedia.org/wiki/Category:%E3%83%9E%E3%83%AB%E3%82%AF%E3%82%B9%EF%BC%9D%E3%82%A8%E3%83%B3%E3%82%B2%E3%83%AB%E3%82%B9,0,0,0,0,0
https://web.archive.org/web/20120123030335/http://www.iboum.com/pr/playon.php,0,0,0,0,0
https://web.archive.org/web/20120123152103/http://www.iboum.com/pr/fan2750.php,0,0,0,0,0
https://web.archive.org/web/20120123032517/http://www.iboum.com/pr/realh3.php,0,0,0,0,0
https://web.archive.org/web/20120123152103/http://www.iboum.com/pr/kai355i.php,0,0,0,0,0
https://web.archive.org/web/20120123030838/http://www.iboum.com/pr/terr740.php,0,0,0,0,0
https://web.archive.org/web/20120123030838/http://www.iboum.com/pr/dune3.php,0,0,0,0,0
https://en.wikipedia.org/wiki/Template:17th_Bundestag_LINKE,0,0,0,0,0
https://web.archive.org/web/20120123041356/http://www.iboum.com/pr/mass1.php,0,0,0,0,0
https://web.archive.org/web/20120123180404/http://www.iboum.com/pr/miccslim.php,0,0,0,0,0
https://en.wikipedia.org/wiki/Herbert_Gintis,0,0,0,0,0
https://web.archive.org/web/20120123051440/http://www.iboum.com/pr/unir55.php,0,0,0,0,0
https://web.archive.org/web/20120123032517/http://www.iboum.com/pr/qnap1000.php,0,0,0,0,0
https://en.wikipedia.org/wiki/Manuel_H%C3%B6ferlin,0,0,0,0,0
https://web.archive.org/web/20120123051440/http://www.iboum.com/pr/nation2.php,0,0,0,0,0
https://web.archive.org/web/20120123041356/http://www.iboum.com/pr/bluec7.php,0,0,0,0,0
https://en.wikipedia.org/wiki/Hans_Grauert,0,0,0,0,0
https://web.archive.org/web/20120123041356/http://www.iboum.com/pr/asusmini.php,0,0,0,0,0
https://web.archive.org/web/20120123152103/http://www.iboum.com/pr/gmin890.php,0,0,0,0,0
https://web.archive.org/web/20120123030838/http://www.iboum.com/pr/eboda500.php,0,0,0,0,0
https://web.archive.org/web/20120123180404/http://www.iboum.com/pr/laclahd.php,0,0,0,0,0
https://web.archive.org/web/20120123033949/http://www.iboum.com/pr/iomegd.php,0,0,0,0,0
https://web.archive.org/web/20120123033949/http://www.iboum.com/pr/him560b.php,0,0,0,0,0
https://zh.wikipedia.org/wiki/Talk:%E5%AE%89%E5%BE%B7%E7%83%88%C2%B7%E6%9F%AF%E7%89%B9%E8%8C%B2,0,0,0,0,0
https://web.archive.org/web/20120123180404/http://www.iboum.com/pr/auvis1.php,0,0,0,0,0
https://web.archive.org/web/20120123051440/http://www.iboum.com/pr/sarot6b.php,0,0,0,0,0
https://web.archive.org/web/20120123030838/http://www.iboum.com/pr/PH100.php,0,0,0,0,0
https://web.archive.org/web/20120123180404/http://www.iboum.com/pr/micca1055.php,0,0,0,0,0
https://web.archive.org/web/20120123041356/http://www.iboum.com/pr/icon7l.php,0,0,0,0,0
https://web.archive.org/web/20120123030838/http://www.iboum.com/pr/sonyu10.php,0,0,0,0,0
https://en.wikipedia.org/wiki/Genlock,0,0,0,0,0
https://ja.wikipedia.org/wiki/8%E6%9C%8824%E6%97%A5,0,0,0,0,0
https://ja.wikipedia.org/wiki/%E7%89%B9%E5%88%A5:%E3%83%AA%E3%83%B3%E3%82%AF%E5%85%83/%E3%82%AB%E3%83%BC%E3%83%AB%E3%83%BB%E3%83%9E%E3%83%AB%E3%82%AF%E3%82%B9,0,0,0,0,0
https://web.archive.org/web/20120123180404/http://www.iboum.com/pr/ferg200a.php,0,0,0,0,0
https://en.wikipedia.org/wiki/Katrin_Helling-Plahr,0,0,0,0,0
https://ja.wikipedia.org/wiki/%E7%89%B9%E5%88%A5:%E9%96%A2%E9%80%A3%E3%83%9A%E3%83%BC%E3%82%B8%E3%81%AE%E6%9B%B4%E6%96%B0%E7%8A%B6%E6%B3%81/%E3%82%AB%E3%83%BC%E3%83%AB%E3%83%BB%E3%83%9E%E3%83%AB%E3%82%AF%E3%82%B9,0,0,0,0,0
https://en.wikipedia.org/wiki/Rachel_and_Stephen_Kaplan,0,0,0,0,0
https://en.wikipedia.org/wiki/Christian_Haase,0,0,0,0,0
https://ja.wikipedia.org/wiki/%E3%83%87%E3%82%A4%E3%83%B4%E3%82%A3%E3%83%83%E3%83%89%E3%83%BB%E3%83%92%E3%83%A5%E3%83%BC%E3%83%A0,0,0,0,0,0
https://web.archive.org/web/20120123032517/http://www.iboum.com/pr/egreatr4b.php,0,0,0,0,0
https://en.wikipedia.org/wiki/Homininae,0,0,0,0,0
https://ja.wikipedia.org/wiki/%E3%83%9C%E3%83%B3%E5%A4%A7%E5%AD%A6,0,0,0,0,0
https://en.wikipedia.org/wiki/Martin_Hess_(politician),0,0,0,0,0
https://web.archive.org/web/20120123030838/http://www.iboum.com/pr/him600c.php,0,0,0,0,0
https://web.archive.org/web/20120123180404/http://www.iboum.com/pr/view75.php,0,0,0,0,0
http://www.ibiblio.org/eldritch/ac/jr/070.htm,0,0,0,0,0
https://web.archive.org/web/20120123180404/http://www.iboum.com/pr/yatay100.php,0,0,0,0,0
https://web.archive.org/web/20120123041356/http://www.iboum.com/pr/eaget900.php,0,0,0,0,0
https://ja.wikipedia.org/wiki/%E3%83%AD%E3%82%B9%E3%83%81%E3%83%A3%E3%82%A4%E3%83%AB%E3%83%89%E5%AE%B6,0,0,0,0,0
https://web.archive.org/web/20120123180404/http://www.iboum.com/pr/sarot6b.php,0,0,0,0,0
https://web.archive.org/web/20120123033949/http://www.iboum.com/pr/e34a.php,0,0,0,0,0
https://web.archive.org/web/20120127063654/http://www.iboum.com/pr/eagetm9.php,0,0,0,0,0
https://web.archive.org/web/20120127063654/http://www.iboum.com/pr/pop35.php,0,0,0,0,0
https://en.wikipedia.org/wiki/Category:Social_Democratic_Party_of_Germany_politician_stubs,0,0,0,0,0
https://web.archive.org/web/20120123152103/http://www.iboum.com/pr/allurem3.php,0,0,0,0,0
https://ja.wikipedia.org/wiki/%E6%95%99%E4%BC%9A%E6%86%B2%E7%AB%A0,0,0,0,0,0
https://web.archive.org/web/20120123033949/http://www.iboum.com/pr/fan2550.php,0,0,0,0,0
https://web.archive.org/web/20120127063654/http://www.iboum.com/pr/kai550.php,0,0,0,0,0
https://web.archive.org/web/20120123051440/http://www.iboum.com/pr/zinwell-5005.php,0,0,0,0,0
https://arz.wikipedia.org/wiki/%D8%AA%D8%B5%D9%86%D9%8A%D9%81:%D9%85%D9%82%D8%A7%D9%84%D8%A7%D8%AA_%D9%8A%D8%AA%D9%8A%D9%85%D9%87,0,0,0,0,0
https://en.wikipedia.org/wiki/Mathias_Stein,0,0,0,0,0
https://en.wikipedia.org/wiki/Ralph_Lenkert,0,0,0,0,0
https://ja.wikipedia.org/wiki/%E6%9D%B1%E4%BA%AC%E5%A4%A7%E5%AD%A6,0,0,0,0,0
https://en.wikipedia.org/wiki/Special:WhatLinksHere/Category:Social_Democratic_Party_of_Germany_politician_stubs,0,0,0,0,0
https://web.archive.org/web/20120123165525/http://www.iboum.com/pr/med4x2.php,0,0,0,0,0
https://arz.wikipedia.org/wiki/(100480)_1996_UK_(%D9%83%D9%88%D9%8A%D9%83%D8%A8),0,0,0,0,0
https://web.archive.org/web/20120123012724/http://www.iboum.com/pr/egreata1080.php,0,0,0,0,0
https://web.archive.org/web/20120123192118/http://www.iboum.com/pr/bevix8078.php,0,0,0,0,0
https://web.archive.org/web/20120123143351/http://www.iboum.com/pr/hdium1.php,0,0,0,0,0
https://web.archive.org/web/20120127060724/http://www.iboum.com/pr/him600b.php,0,0,0,0,0
https://web.archive.org/web/20120123180736/http://www.iboum.com/pr/acfluxx.php,0,0,0,0,0
https://web.archive.org/web/20120123053154/http://www.iboum.com/pr/med5x2.php,0,0,0,0,0
https://web.archive.org/web/20120126130700/http://www.iboum.com/pr/hi300a.php,0,0,0,0,0
https://web.archive.org/web/20120126123436/http://www.iboum.com/pr/terr740.php,0,0,0,0,0
https://ja.wikipedia.org/wiki/%E3%82%B8%E3%83%A7%E3%82%BC%E3%83%BB%E3%83%9C%E3%82%B7%E3%83%B3%E3%82%B0%E3%83%AF,0,0,0,0,0
https://web.archive.org/web/20120123124929/http://www.iboum.com/pr/bolmob.php,0,0,0,0,0
https://web.archive.org/web/20120123014930/http://www.iboum.com/pr/emtecv120.php,0,0,0,0,0
https://web.archive.org/web/20120123124929/http://www.iboum.com/pr/playon-plus.php,0,0,0,0,0
https://web.archive.org/web/20120123021254/http://www.iboum.com/pr/ggsony1.php,0,0,0,0,0
https://de.wikipedia.org/wiki/%C3%96sterreichischer_Erbfolgekrieg,0,0,0,0,0
https://web.archive.org/web/20120126155549/http://www.iboum.com/pr/darkmm.php,0,0,0,0,0
https://web.archive.org/web/20120127061259/http://www.iboum.com/pr/iomegspd.php,0,0,0,0,0
https://ja.wikipedia.org/wiki/%E6%A0%B9%E5%B2%B8%E5%90%89%E5%A4%AA%E9%83%8E,0,0,0,0,0
https://ja.wikipedia.org/wiki/%E4%B9%9D%E5%B7%9E%E3%83%AB%E3%83%BC%E3%83%86%E3%83%AB%E5%AD%A6%E9%99%A2%E5%A4%A7%E5%AD%A6,0,0,0,0,0
https://web.archive.org/web/20120123112030/http://www.iboum.com/artkill/media-player-glossary.php,0,0,0,0,0
https://web.archive.org/web/20120127063548/http://www.iboum.com/pr/roku1.php,0,0,0,0,0
https://web.archive.org/web/20120123161930/http://www.iboum.com/pr/kai750li.php,0,0,0,0,0
https://web.archive.org/web/20120123185302/http://www.iboum.com/pr/melev6.php,0,0,0,0,0
https://web.archive.org/web/20120123184919/http://www.iboum.com/pr/dx320.php,0,0,0,0,0
https://web.archive.org/web/20120118185051/http://www.iboum.com/pr/kai360i.php,0,0,0,0,0
https://web.archive.org/web/20120123192118/http://www.iboum.com/pr/ggsony1.php,0,0,0,0,0
https://ar.wikipedia.org/wiki/%D9%81%D8%B5%D9%8A%D9%84%D8%A9_%D8%A7%D9%84%D8%A5%D9%86%D8%B3%D8%A7%D9%86%D9%8A%D8%A7%D8%AA,0,0,0,0,0
https://web.archive.org/web/20120127061837/http://www.iboum.com/pr/acerrview.php,0,0,0,0,0
https://en.wikipedia.org/wiki/Robert_W._Vishny,0,0,0,0,0
https://web.archive.org/web/20120126131042/http://www.iboum.com/pr/view75.php,0,0,0,0,0
https://web.archive.org/web/20120103192934/http://www.iboum.com:80/pr/asusmini.php,0,0,0,0,0
https://web.archive.org/web/20120123040430/http://www.iboum.com/pr/hi300a.php,0,0,0,0,0
https://web.archive.org/web/20120127061259/http://www.iboum.com/pr/rokuxds.php,0,0,0,0,0
https://web.archive.org/web/20120123164545/http://www.iboum.com/pr/howv2.php,0,0,0,0,0
https://web.archive.org/web/20120123184919/http://www.iboum.com/pr/prodigi100.php,0,0,0,0,0
https://web.archive.org/web/20120123185107/http://www.iboum.com/pr/bev808.php,0,0,0,0,0
https://web.archive.org/web/20120123054425/http://www.iboum.com/pr/sumcyclone.php,0,0,0,0,0
https://de.wikipedia.org/wiki/Schlacht_bei_Ro%C3%9Fbach,0,0,0,0,0
https://web.archive.org/web/20120118185051/http://www.iboum.com/pr/bev805.php,0,0,0,0,0
https://web.archive.org/web/20120123053154/http://www.iboum.com/pr/wdtvlive11.php,0,0,0,0,0
https://ja.wikipedia.org/wiki/7%E6%9C%886%E6%97%A5,0,0,0,0,0
https://ja.wikipedia.org/wiki/%E6%96%87%E6%98%8E,0,0,0,0,0
https://de.wikipedia.org/wiki/Infanteriegewehr_Modell_1723,23,0,0,0,23
https://ja.wikipedia.org/wiki/28%E6%97%A5,0,0,0,0,0
https://web.archive.org/web/20120123025919/http://www.iboum.com/pr/WDTV2-LIVE.php,0,0,0,0,0
https://web.archive.org/web/20120127061259/http://www.iboum.com/bloog/,0,0,0,0,0
https://web.archive.org/web/20120123192840/http://www.iboum.com/pr/mede8er.php,0,0,0,0,0
https://web.archive.org/web/20120123185107/http://www.iboum.com/pr/midt1080.php,0,0,0,0,0
https://web.archive.org/web/20120123014643/http://www.iboum.com/pr/ng9150.php,0,0,0,0,0
https://web.archive.org/web/20120123025919/http://www.iboum.com/pr/icy311.php,0,0,0,0,0
https://web.archive.org/web/20120127063644/http://www.iboum.com/pr/sage300.php,0,0,0,0,0
https://web.archive.org/web/20120123180736/http://www.iboum.com/pr/egreat-s1b.php,0,0,0,0,0
https://web.archive.org/web/20120123112030/http://www.iboum.com/pr/sage200.php,0,0,0,0,0
https://web.archive.org/web/20120123161930/http://www.iboum.com/pr/egr100.php,0,0,0,0,0
https://web.archive.org/web/20120123184919/http://www.iboum.com/pr/aigop6a.php,0,0,0,0,0
https://web.archive.org/web/20120123060223/http://www.iboum.com/pr/howv2.php,0,0,0,0,0
https://web.archive.org/web/20120123143351/http://www.iboum.com/pr/gmin890.php,0,0,0,0,0
https://ja.wikipedia.org/wiki/%E6%8E%A2%E6%A4%9C%E5%AE%B6,0,0,0,0,0
https://web.archive.org/web/20120123154217/http://www.iboum.com/pr/avercin.php,0,0,0,0,0
https://web.archive.org/web/20120123121541/http://www.iboum.com/pr/bev808.php,0,0,0,0,0
https://web.archive.org/web/20120123174620/http://www.iboum.com/pr/howh3.php,0,0,0,0,0
https://web.archive.org/web/20120127063548/http://www.iboum.com/pr/dune-smart-d1.php,0,0,0,0,0
https://web.archive.org/web/20120123014930/http://www.iboum.com/pr/iomegdx.php,0,0,0,0,0
https://web.archive.org/web/20120123114557/http://www.iboum.com/pr/ferg110.php,0,0,0,0,0
https://web.archive.org/web/20120123181353/http://www.iboum.com/pr/him600a.php,0,0,0,0,0
https://de.wikipedia.org/wiki/Schlacht_bei_Leuthen,0,0,0,0,0
https://web.archive.org/web/20120123060223/http://www.iboum.com/pr/eagetx5.php,0,0,0,0,0
https://web.archive.org/web/20120123174620/http://www.iboum.com/pr/realh3.php,0,0,0,0,0
https://web.archive.org/web/20120127061837/http://www.iboum.com/pr/kodakt1.php,0,0,0,0,0
https://web.archive.org/web/20120123121541/http://www.iboum.com/pr/dune301.php,0,0,0,0,0
https://web.archive.org/web/20120123162510/http://www.iboum.com/pr/micc350.php,0,0,0,0,0
https://web.archive.org/web/20120123054425/http://www.iboum.com/pr/giec160.php,0,0,0,0,0
https://web.archive.org/web/20120123114557/http://www.iboum.com/pr/mykam.php,0,0,0,0,0
https://web.archive.org/web/20120123163818/http://www.iboum.com/pr/acplayhdp.php,0,0,0,0,0
https://web.archive.org/web/20120123021254/http://www.iboum.com/pr/mygv5.php,0,0,0,0,0
https://web.archive.org/web/20120123134754/http://www.iboum.com/pr/eaget8802.php,0,0,0,0,0
https://web.archive.org/web/20120123165525/http://www.iboum.com/pr/genand1.php,0,0,0,0,0
https://ja.wikipedia.org/wiki/%E3%82%A2%E3%83%B3%E3%82%BC%E3%83%AB%E3%83%A0%E3%83%BB%E3%83%95%E3%82%A9%E3%83%B3%E3%83%BB%E3%83%AD%E3%83%BC%E3%83%88%E3%82%B7%E3%83%AB%E3%83%88,0,0,0,0,0
https://web.archive.org/web/20120123144542/http://www.iboum.com/pr/realh3.php,0,0,0,0,0
https://ja.wikipedia.org/wiki/%E3%83%95%E3%82%A1%E3%82%A4%E3%83%AB:SiegeofAntioch.jpeg,0,0,0,0,0
https://web.archive.org/web/20120127035328/http://www.iboum.com/pr/dx390.php,0,0,0,0,0
https://web.archive.org/web/20120127061837/http://www.iboum.com/pr/kwm200.php,0,0,0,0,0
https://web.archive.org/web/20120123012724/http://www.iboum.com/pr/WDTV2-LIVE.php,0,0,0,0,0
https://web.archive.org/web/20120123121541/http://www.iboum.com/pr/sumcyc2.php,0,0,0,0,0
https://web.archive.org/web/20120123161930/http://www.iboum.com/pr/pha210.php,0,0,0,0,0
https://web.archive.org/web/20120123115521/http://www.iboum.com/pr/eeemed1.php,0,0,0,0,0
https://web.archive.org/web/20120127063644/http://www.iboum.com/pr/roku2xs.php,0,0,0,0,0
https://web.archive.org/web/20120123163818/http://www.iboum.com/pr/zinwell-5005.php,0,0,0,0,0
https://web.archive.org/web/20120123060223/http://www.iboum.com/pr/d-pebble.php,0,0,0,0,0
https://web.archive.org/web/20120127063644/http://www.iboum.com/pr/miccamhd.php,0,0,0,0,0
https://web.archive.org/web/20130308103953/http://www.iboum.com:80/pr/eaget900.php,0,0,0,0,0
https://ja.wikipedia.org/wiki/%E3%83%95%E3%82%A1%E3%82%A4%E3%83%AB:View_of_Nature_Reserve_from_St._Agatha%27s_Tower.JPG,0,0,0,0,0
https://web.archive.org/web/20120123124929/http://www.iboum.com/pr/ph3000.php,0,0,0,0,0
https://web.archive.org/web/20120123154217/http://www.iboum.com/pr/dunemax.php,0,0,0,0,0
https://web.archive.org/web/20120123162510/http://www.iboum.com/pr/ariva150.php,0,0,0,0,0
https://web.archive.org/web/20120126130700/http://www.iboum.com/pr/astep05.php,0,0,0,0,0
https://web.archive.org/web/20120123040430/http://www.iboum.com/pr/him300b.php,0,0,0,0,0
https://ja.wikipedia.org/wiki/%E3%83%95%E3%82%A1%E3%82%A4%E3%83%AB:Anthem-of-Ukraine_Chorus_Veryovka.ogg,0,0,0,0,0
https://en.wikipedia.org/wiki/Category:Rostock_University_of_Music_and_Theatre_alumni,0,0,0,0,0
https://web.archive.org/web/20120123014643/http://www.iboum.com/pr/micep600.php,0,0,0,0,0
https://en.wikipedia.org/wiki/Sheaf_theory,0,0,0,0,0
https://web.archive.org/web/20120123164545/http://www.iboum.com/pr/ibox400.php,0,0,0,0,0
https://web.archive.org/web/20120123040430/http://www.iboum.com/pr/dune53.php,0,0,0,0,0
https://web.archive.org/web/20120123180736/http://www.iboum.com/pr/apple-cloud-tv.php,0,0,0,0,0
https://web.archive.org/web/20120123165525/http://www.iboum.com/artkill/chipsets.php,0,0,0,0,0
https://web.archive.org/web/20120126155549/http://www.iboum.com/pr/ferg310.php,0,0,0,0,0
https://www.wort.lu/de/business/scandale-1mdb-la-justice-passe-a-l-action-578f8697ac730ff4e7f63c98,0,0,0,0,0
https://www.wikidata.org/wiki/Special:EntityPage/Q8705781,0,0,0,0,0
https://ja.wikipedia.org/wiki/%E3%83%97%E3%83%AD%E3%82%B8%E3%82%A7%E3%82%AF%E3%83%88:%E5%9B%BD,0,0,0,0,0
https://web.archive.org/web/20120123051324/http://www.iboum.com/pr/boxee-box.php,0,0,0,0,0
https://web.archive.org/web/20120123162510/http://www.iboum.com/pr/kai860i.php,0,0,0,0,0
https://web.archive.org/web/20120127035328/http://www.iboum.com/pr/genand1.php,0,0,0,0,0
https://web.archive.org/web/20120123172641/http://www.iboum.com/pr/terr520.php,0,0,0,0,0
https://web.archive.org/web/20120126162319/http://www.iboum.com/pr/eageth5.php,0,0,0,0,0
https://web.archive.org/web/20120123014643/http://www.iboum.com/pr/diyoxs.php,0,0,0,0,0
https://fr.wikipedia.org/wiki/Famille_Rothschild,0,0,0,0,0
https://web.archive.org/web/20120123215714/http://statcounter.com/bbedit/,0,0,0,0,0
https://web.archive.org/web/20120123160634/http://www.iboum.com/pr/bev808.php,0,0,0,0,0
https://web.archive.org/web/20120123185302/http://www.futeko.com/navpage/media-players.php,0,0,0,0,0
https://web.archive.org/web/20120123112030/http://www.iboum.com/pr/datastor.php,0,0,0,0,0
https://web.archive.org/web/20120123163818/http://www.iboum.com/pr/em200.php,0,0,0,0,0
https://ja.wikipedia.org/wiki/%E3%83%95%E3%82%A1%E3%82%A4%E3%83%AB:Laoshe.jpg,0,0,0,0,0
https://web.archive.org/web/20120123160634/http://www.iboum.com/pr/sage300.php,0,0,0,0,0
https://web.archive.org/web/20120123154217/http://www.iboum.com/pr/ac-playon-dvr.php,0,0,0,0,0
https://web.archive.org/web/20120127060724/http://www.iboum.com/pr/howu5.php,0,0,0,0,0
https://ja.wikipedia.org/wiki/%E3%82%AF%E3%82%A8%E3%83%B3%E3%82%AB_(%E3%82%A8%E3%82%AF%E3%82%A2%E3%83%89%E3%83%AB),0,0,0,0,0
https://web.archive.org/web/20120123160634/http://www.iboum.com/pr/him200b.php,0,0,0,0,0
https://web.archive.org/web/20120123020919/http://www.android-tablet-comparison-world.com/,0,0,0,0,0
https://web.archive.org/web/20120125063300/http://www.iboum.com/pr/egreatr4b.php,0,0,0,0,0
https://web.archive.org/web/20120123185107/http://www.iboum.com/pr/bevix6058.php,0,0,0,0,0
https://web.archive.org/web/20120123185302/http://www.iboum.com/pr/emk220h.php,0,0,0,0,0
https://web.archive.org/web/20120123154217/http://www.iboum.com/pr/auvis1.php,0,0,0,0,0
https://web.archive.org/web/20120123054635/http://www.iboum.com/pr/leagues1.php,0,0,0,0,0
https://web.archive.org/web/20120123051324/http://www.iboum.com/pr/lgxf2.php,0,0,0,0,0
https://web.archive.org/web/20120123012724/http://www.iboum.com/pr/nationite-hdvp1.php,0,0,0,0,0
https://kab.wikipedia.org/wiki/24_%C9%A3uct,0,0,0,0,0
https://uk.wikipedia.org/wiki/%D0%93%D0%B5%D2%91%D0%B5%D0%BB%D1%8C_%D2%90%D0%B5%D0%BE%D1%80%D2%91_%D0%92%D1%96%D0%BB%D1%8C%D0%B3%D0%B5%D0%BB%D1%8C%D0%BC_%D0%A4%D1%80%D1%96%D0%B4%D1%80%D1%96%D1%85,0,0,0,0,0
https://web.archive.org/web/20120123054635/http://www.iboum.com/pr/PH100.php,0,0,0,0,0
https://web.archive.org/web/20120123180736/http://www.iboum.com/pr/qnap1000p.php,0,0,0,0,0
https://web.archive.org/web/20120123143351/http://www.iboum.com/pr/xtreamsid2.php,0,0,0,0,0
https://web.archive.org/web/20120127021100/http://www.iboum.com/pr/dopodo2000.php,0,0,0,0,0
https://web.archive.org/web/20120123054635/http://www.iboum.com/pr/dopodo2000.php,0,0,0,0,0
https://ja.wikipedia.org/wiki/%E3%82%B7%E3%83%A2%E3%83%B3%E3%83%BB%E3%83%89%E3%83%BB%E3%83%A2%E3%83%B3%E3%83%95%E3%82%A9%E3%83%BC%E3%83%AB_(%E7%AC%AC5%E4%BB%A3%E3%83%AC%E3%82%B9%E3%82%BF%E3%83%BC%E4%BC%AF%E7%88%B5),0,0,0,0,0
https://web.archive.org/web/20120123154217/http://www.iboum.com/pr/myga3.php,0,0,0,0,0
https://web.archive.org/web/20120123172641/http://www.iboum.com/pr/eagetm90.php,0,0,0,0,0
https://web.archive.org/web/20120123180736/http://www.iboum.com/artkill/hd-audio-media-players.php,0,0,0,0,0
https://ja.wikipedia.org/wiki/%E8%A5%BF%E3%83%AD%E3%83%BC%E3%83%9E%E5%B8%9D%E5%9B%BD,0,0,0,0,0
https://web.archive.org/web/20120123053154/http://www.iboum.com/pr/egreatrm1.php,0,0,0,0,0
https://web.archive.org/web/20120123040430/http://www.android-tablet-comparison-world.com/,0,0,0,0,0
https://web.archive.org/web/20120123025919/http://www.iboum.com/pr/miccmplay.php,0,0,0,0,0
https://web.archive.org/web/20120123115521/http://www.iboum.com/pr/medianow101.php,0,0,0,0,0
https://web.archive.org/web/20120123181353/http://www.iboum.com/pr/roku2xs.php,0,0,0,0,0
https://web.archive.org/web/20120123121541/http://www.iboum.com/pr/laclahd.php,0,0,0,0,0
https://web.archive.org/web/20120123024858/http://www.iboum.com/pr/egreata1080.php,0,0,0,0,0
https://en.wikipedia.org/wiki/Albert_O._Hirschman,0,0,0,0,0
https://web.archive.org/web/20120127063548/http://www.iboum.com/pr/wdtv-elephant-play.php,0,0,0,0,0
https://web.archive.org/web/20120123115521/http://www.iboum.com/pr/astep05.php,0,0,0,0,0
https://web.archive.org/web/20120123144542/http://www.iboum.com/pr/yanghdpro+.php,0,0,0,0,0
https://web.archive.org/web/20120123134754/http://www.iboum.com/pr/diamond-mp-1000.php,0,0,0,0,0
https://web.archive.org/web/20120127061837/http://www.iboum.com/artkill/hd-audio-media-players.php,0,0,0,0,0
https://web.archive.org/web/20120123020919/http://www.iboum.com/pr/ariva150.php,0,0,0,0,0
https://web.archive.org/web/20120123185302/http://www.iboum.com/pr/kaih1055.php,0,0,0,0,0
https://web.archive.org/web/20120123012724/http://www.iboum.com/pr/PHA200.php,0,0,0,0,0
https://web.archive.org/web/20120126155549/http://www.iboum.com/pr/avextreme.php,0,0,0,0,0
https://ja.wikipedia.org/wiki/%E7%80%A7%E5%B1%B1%E4%B9%85%E5%BF%97,0,0,0,0,0
https://web.archive.org/web/20120123181353/http://www.iboum.com/pr/enc211.php,0,0,0,0,0
https://web.archive.org/web/20120123020919/http://www.iboum.com/pr/egreatr1.php,0,0,0,0,0
https://web.archive.org/web/20120123014930/http://www.iboum.com/pr/sarot6b.php,0,0,0,0,0
https://ja.wikipedia.org/wiki/%E9%87%91%E6%B2%A2%E5%B8%82,0,0,0,0,0
https://web.archive.org/web/20120123115521/http://www.iboum.com/pr/kogitv.php,0,0,0,0,0
https://web.archive.org/web/20120123181353/http://www.iboum.com/pr/meleg02.php,0,0,0,0,0
https://web.archive.org/web/20120123025919/http://www.iboum.com/pr/eagetm7.php,0,0,0,0,0
https://ja.wikipedia.org/wiki/1218%E5%B9%B4,0,0,0,0,0
https://web.archive.org/web/20120123020542/http://www.iboum.com/pr/yatay100.php,0,0,0,0,0
https://ja.wikipedia.org/wiki/4%E6%9C%8813%E6%97%A5,0,0,0,0,0
https://web.archive.org/web/20120126155549/http://www.iboum.com/pr/bevix6010.php,0,0,0,0,0
https://arz.wikipedia.org/wiki/%D8%A7%D9%8A%D9%86%D8%AC%D8%A8%D9%8A%D8%B1%D8%AA_%D9%84%D9%8A%D8%A8%D9%8A%D9%86%D8%AC,0,0,0,0,0
https://ja.wikipedia.org/wiki/%E6%83%91%E6%98%9F,0,0,0,0,0
https://web.archive.org/web/20120123025114/http://www.iboum.com/pr/roku2lt.php,0,0,0,0,0
https://web.archive.org/web/20120126162319/http://www.iboum.com/pr/sitecom270.php,0,0,0,0,0
https://web.archive.org/web/20120123012724/http://www.iboum.com/pr/novad58.php,0,0,0,0,0
https://web.archive.org/web/20120123053154/http://www.iboum.com/pr/kai750li.php,0,0,0,0,0
https://web.archive.org/web/20120123021254/http://www.iboum.com/pr/conc-cm3hd.php,0,0,0,0,0
https://web.archive.org/web/20120123164255/http://www.iboum.com/pr/fansmdisk.php,0,0,0,0,0
https://web.archive.org/web/20120123172641/http://www.iboum.com/pr/tizzf30.php,0,0,0,0,0
https://web.archive.org/web/20120127063548/http://www.iboum.com/pr/kai580i.php,0,0,0,0,0
https://web.archive.org/web/20120123184919/http://www.iboum.com/pr/bluec7.php,0,0,0,0,0
https://web.archive.org/web/20120123060223/http://www.iboum.com/pr/dune-smart-h1.php,0,0,0,0,0
https://ja.wikipedia.org/wiki/%E7%A4%BE%E4%BC%9A%E7%A7%91%E5%AD%A6,0,0,0,0,0
https://web.archive.org/web/20120123114557/http://www.iboum.com/pr/avercin.php,0,0,0,0,0
https://web.archive.org/web/20120123124929/http://www.iboum.com/pr/roku2lt.php,0,0,0,0,0
https://uk.wikipedia.org/wiki/%D0%9C%D0%BE%D0%B6%D0%BB%D0%B8%D0%B2%D1%96%D1%81%D1%82%D1%8C,0,0,0,0,0
https://en.wikipedia.org/wiki/Category:Container_categories,0,0,0,0,0
https://web.archive.org/web/20120123024858/http://www.iboum.com/pr/yangh2.php,0,0,0,0,0
https://web.archive.org/web/20120126130700/http://www.iboum.com/pr/dune.php,0,0,0,0,0
https://web.archive.org/web/20120123164255/http://www.iboum.com/pr/astone300.php,0,0,0,0,0
https://br.wikipedia.org/wiki/24_Eost,0,0,0,0,0
https://web.archive.org/web/20120123054425/http://www.iboum.com/pr/noonv8p.php,0,0,0,0,0
https://arz.wikipedia.org/wiki/(102347)_1999_TJ122_(%D9%83%D9%88%D9%8A%D9%83%D8%A8),0,0,0,0,0
https://web.archive.org/web/20120127035328/http://www.iboum.com/pr/med45x2.php,0,0,0,0,0
https://web.archive.org/web/20120127061837/http://www.iboum.com/pr/iconx100.php,0,0,0,0,0
https://web.archive.org/web/20120123172641/http://www.iboum.com/pr/wdtv-elephant-play.php,0,0,0,0,0
https://web.archive.org/web/20120123115521/http://www.iboum.com/pr/egs7a.php,0,0,0,0,0
https://web.archive.org/web/20120118185051/http://www.iboum.com/pr/miccslim.php,0,0,0,0,0
https://web.archive.org/web/20120123174620/http://www.iboum.com/pr/acerrview.php,0,0,0,0,0
https://web.archive.org/web/20120123124929/http://www.iboum.com/pr/egr180.php,0,0,0,0,0
https://web.archive.org/web/20120123164545/http://www.iboum.com/pr/meas8hd.php,0,0,0,0,0
https://web.archive.org/web/20120123033309/http://www.iboum.com/pr/measyx7.php,0,0,0,0,0
https://web.archive.org/web/20120123154217/http://www.iboum.com/pr/ferg110.php,0,0,0,0,0
https://web.archive.org/web/20120123033309/http://www.iboum.com/pr/midt1080.php,0,0,0,0,0
https://de.wikipedia.org/wiki/Wikipedia:Lesenswerte_Artikel,0,0,0,0,0
https://web.archive.org/web/20120123014930/http://www.iboum.com/pr/bev8038.php,0,0,0,0,0
https://web.archive.org/web/20120127060724/http://www.iboum.com/pr/acfluxx.php,0,0,0,0,0
https://de.wikipedia.org/wiki/Gardekorps,0,0,0,0,0
https://web.archive.org/web/20120123180736/http://www.iboum.com/pr/him600b.php,0,0,0,0,0
https://web.archive.org/web/20080307040938/http://www.etext.leeds.ac.uk:80/hume/,0,0,0,0,0
https://web.archive.org/web/20120123054635/http://www.iboum.com/pr/micep600.php,0,0,0,0,0
https://ja.wikipedia.org/wiki/5%E6%9C%8825%E6%97%A5,0,0,0,0,0
https://ja.wikipedia.org/wiki/%E9%99%84%E5%B1%9E%E5%AD%A6%E6%A0%A1,0,0,0,0,0
https://web.archive.org/web/20120123160634/http://www.iboum.com/pr/roku2xs.php,0,0,0,0,0
https://web.archive.org/web/20120123020919/http://www.iboum.com/pr/eagetm7.php,0,0,0,0,0
https://ja.wikipedia.org/wiki/%E3%83%AC%E3%82%BD%E3%83%88,0,0,0,0,0
https://web.archive.org/web/20120123160634/http://www.iboum.com/pr/meleg02.php,0,0,0,0,0
https://web.archive.org/web/20120123115521/http://www.iboum.com/pr/nix1000.php,0,0,0,0,0
https://www.dw.com/en/google/t-17454571,0,0,0,0,0
https://web.archive.org/web/20120123053950/http://www.iboum.com/pr/icy316.php,0,0,0,0,0
https://web.archive.org/web/20120123171624/http://www.iboum.com/pr/eagetm9.php,0,0,0,0,0
https://web.archive.org/web/20120123032459/http://www.iboum.com/bloog/,0,0,0,0,0
https://web.archive.org/web/20120123171624/http://www.iboum.com/pr/evoblade.php,0,0,0,0,0
https://web.archive.org/web/20120123174143/http://www.iboum.com/pr/midt1080.php,0,0,0,0,0
https://ja.wikipedia.org/wiki/7%E4%B8%96%E7%B4%80,0,0,0,0,0
https://web.archive.org/web/20120123043106/http://www.iboum.com/pr/ideri6fh.php,0,0,0,0,0
https://ja.wikipedia.org/wiki/%E6%97%A5%E9%87%8E%E5%8B%9D%E5%85%89,0,0,0,0,0
https://web.archive.org/web/20120123034946/http://www.iboum.com/pr/evosol.php,0,0,0,0,0
https://uk.wikipedia.org/wiki/%D0%9F%D0%BE%D1%82%D1%80%D0%B5%D0%B1%D0%B0,0,0,0,0,0
https://ja.wikipedia.org/wiki/%E3%83%94%E3%82%A2%E3%83%8B%E3%82%B9%E3%83%88,0,0,0,0,0
https://web.archive.org/web/20120123021353/http://www.iboum.com/pr/eagetx5.php,0,0,0,0,0
https://web.archive.org/web/20120123164334/http://www.iboum.com/pr/med85015.php,0,0,0,0,0
https://web.archive.org/web/20120127062941/http://www.iboum.com/pr/LARUG.php,0,0,0,0,0
https://de.wikipedia.org/wiki/Zerspanen,1,0,0,0,1
https://web.archive.org/web/20120123022549/http://www.iboum.com/pr/med4x2.php,0,0,0,0,0
https://d-nb.info/gnd/135984297,0,0,0,0,0
https://web.archive.org/web/20120123181047/http://www.iboum.com/pr/kai355i.php,0,0,0,0,0
https://web.archive.org/web/20120123024407*/http://www.iboum.com/pr/bevix6058.php,0,0,0,0,0
https://web.archive.org/web/20120123025125/http://www.iboum.com/pr/datprod.php,0,0,0,0,0
https://web.archive.org/web/20120126160119/http://www.iboum.com/pr/dxdroid.php,0,0,0,0,0
https://web.archive.org/web/20120123111833/http://www.iboum.com/pr/eagetx5.php,0,0,0,0,0
https://web.archive.org/web/20120123162653/http://www.iboum.com/pr/egr180.php,0,0,0,0,0
https://ja.wikipedia.org/wiki/1255%E5%B9%B4,0,0,0,0,0
https://web.archive.org/web/20120123042915/http://www.iboum.com/pr/tvix7000.php,0,0,0,0,0
https://uk.wikipedia.org/wiki/VII_%D1%81%D1%82%D0%BE%D0%BB%D1%96%D1%82%D1%82%D1%8F,0,0,0,0,0
https://web.archive.org/web/20120123172154/http://www.iboum.com/pr/him800b.php,0,0,0,0,0
https://web.archive.org/web/20120123181850/http://www.iboum.com/pr/haup-mvphd.php,0,0,0,0,0
https://web.archive.org/web/20120123181850/http://www.iboum.com/pr/icon4sl.php,0,0,0,0,0
https://de.wikipedia.org/wiki/Schleifmittel,0,0,0,0,0
https://web.archive.org/web/20120126120549/http://www.iboum.com/pr/avextreme.php,0,0,0,0,0
https://web.archive.org/web/20120123013446/http://www.iboum.com/pr/eaget8802.php,0,0,0,0,0
https://web.archive.org/web/20120123190344/http://www.iboum.com/pr/egr12.php,0,0,0,0,0
https://ja.wikipedia.org/wiki/668%E5%B9%B4,0,0,0,0,0
https://ja.wikipedia.org/wiki/%E3%83%A4%E3%83%B3%E3%83%BB%E3%83%91%E3%83%8D%E3%83%B3%E3%82%AB,0,0,0,0,0
https://ja.wikipedia.org/wiki/%E3%82%A6%E3%83%9E%E3%83%AB%E3%83%BB%E3%82%A4%E3%83%96%E3%83%B3%E3%83%BB%E3%83%8F%E3%83%83%E3%82%BF%E3%83%BC%E3%83%96,0,0,0,0,0
https://web.archive.org/web/20120123122404/http://www.iboum.com/pr/FREEAG.php,0,0,0,0,0
https://web.archive.org/web/20120123054531/http://www.iboum.com/pr/xtsid3.php,0,0,0,0,0
https://web.archive.org/web/20120123172935/http://www.iboum.com/pr/envivoa.php,0,0,0,0,0
https://web.archive.org/web/20120123054531/http://www.iboum.com/pr/sumcyc2.php,0,0,0,0,0
https://ja.wikipedia.org/wiki/%E3%82%B9%E3%83%B3%E3%83%8A,0,0,0,0,0
https://web.archive.org/web/20120123122404/http://www.iboum.com/pr/musicb200.php,0,0,0,0,0
https://web.archive.org/web/20120123162217/http://www.iboum.com/pr/pop35.php,0,0,0,0,0
https://web.archive.org/web/20120123172935/http://www.iboum.com/pr/acerrview.php,0,0,0,0,0
https://web.archive.org/web/20120123054531/http://www.iboum.com/pr/sumcycmicro.php,0,0,0,0,0
https://web.archive.org/web/20120123122404/http://www.iboum.com/pr/eagetm7.php,0,0,0,0,0
https://web.archive.org/web/20120123162217/mailto:mail@iboum.com,0,0,0,0,0
https://web.archive.org/web/20120123054531/http://www.iboum.com/pr/novad29.php,0,0,0,0,0
https://web.archive.org/web/20120123172935/http://www.iboum.com/pr/giec260.php,0,0,0,0,0
https://ja.wikipedia.org/wiki/%E3%82%A2%E3%83%AA%E3%83%BC%E3%83%BB%E3%82%A4%E3%83%96%E3%83%B3%E3%83%BB%E3%82%A2%E3%83%93%E3%83%BC%E3%83%BB%E3%82%BF%E3%83%BC%E3%83%AA%E3%83%96,0,0,0,0,0
https://web.archive.org/web/20120123122404/http://www.iboum.com/pr/pha300.php,0,0,0,0,0
https://web.archive.org/web/20120123054531/http://www.iboum.com/pr/him900d.php,0,0,0,0,0
https://uk.wikipedia.org/wiki/%D0%A2%D1%8E%D1%80%D0%BA%D1%81%D1%8C%D0%BA%D0%B8%D0%B9_%D0%BA%D0%B0%D0%B3%D0%B0%D0%BD%D0%B0%D1%82,0,0,0,0,0
https://web.archive.org/web/20120123162217/http://www.iboum.com/pr/roku1.php,0,0,0,0,0
https://web.archive.org/web/20120123122404/http://www.iboum.com/pr/egs7a.php,0,0,0,0,0
https://web.archive.org/web/20120123172935/http://www.iboum.com/pr/him900b.php,0,0,0,0,0
https://web.archive.org/web/20120123162217/http://www.iboum.com/pr/eagetm6.php,0,0,0,0,0
https://web.archive.org/web/20120123172935/http://www.iboum.com/pr/eagetm9.php,0,0,0,0,0
https://web.archive.org/web/20120123172935/http://www.iboum.com/pr/yuxx.php,0,0,0,0,0
https://web.archive.org/web/20120123054531/http://www.iboum.com/pr/ol3hd.php,0,0,0,0,0
https://web.archive.org/web/20120123054531/http://www.iboum.com/pr/howu5.php,0,0,0,0,0
https://web.archive.org/web/20120123122404/http://www.iboum.com/pr/kai580.php,0,0,0,0,0
https://web.archive.org/web/20120123162217/http://www.iboum.com/pr/hornetfan.php,0,0,0,0,0
https://ja.wikipedia.org/wiki/%E7%89%B9%E5%88%A5:%E3%83%AA%E3%83%B3%E3%82%AF%E5%85%83/%E3%82%A6%E3%83%9E%E3%83%AB%E3%83%BB%E3%82%A4%E3%83%96%E3%83%B3%E3%83%BB%E3%83%8F%E3%83%83%E3%82%BF%E3%83%BC%E3%83%96,0,0,0,0,0
https://web.archive.org/web/20120123172935/http://www.iboum.com/pr/dx320.php,0,0,0,0,0
https://web.archive.org/web/20120123162217/http://www.iboum.com/pr/elek700.php,0,0,0,0,0
https://web.archive.org/web/20120123172935/http://www.iboum.com/pr/gmin890.php,0,0,0,0,0
https://web.archive.org/web/20120123162217/http://www.iboum.com/pr/crystmm.php,0,0,0,0,0
https://uk.wikipedia.org/wiki/%D0%91%D0%B0%D0%B2%D0%B0%D1%80%D0%B8,0,0,0,0,0
https://web.archive.org/web/20120123172935/http://www.iboum.com/pr/roku2lt.php,0,0,0,0,0
https://web.archive.org/web/20120123162217/http://www.iboum.com/pr/giec160.php,0,0,0,0,0
https://web.archive.org/web/20120123172935/http://www.iboum.com/pr/lg-dp1w.php,0,0,0,0,0
https://web.archive.org/web/20120123172935/http://www.iboum.com/pr/arg335.php,0,0,0,0,0
https://web.archive.org/web/20120123162217/http://www.iboum.com/pr/brite-cinemago.php,0,0,0,0,0
https://web.archive.org/web/20120123122404/http://www.iboum.com/pr/lenlhd80.php,0,0,0,0,0
https://ja.wikipedia.org/wiki/%E7%89%B9%E5%88%A5:%E9%96%A2%E9%80%A3%E3%83%9A%E3%83%BC%E3%82%B8%E3%81%AE%E6%9B%B4%E6%96%B0%E7%8A%B6%E6%B3%81/%E3%82%A6%E3%83%9E%E3%83%AB%E3%83%BB%E3%82%A4%E3%83%96%E3%83%B3%E3%83%BB%E3%83%8F%E3%83%83%E3%82%BF%E3%83%BC%E3%83%96,0,0,0,0,0
https://web.archive.org/web/20120123122404/http://www.iboum.com/pr/kogitv.php,0,0,0,0,0
https://web.archive.org/web/20120123054531/http://www.iboum.com/pr/bevix6058.php,0,0,0,0,0
https://web.archive.org/web/20120123122404/http://www.iboum.com/pr/acplayhdp.php,0,0,0,0,0
https://web.archive.org/web/20120123054531/http://www.iboum.com/pr/nation2.php,0,0,0,0,0
https://ja.wikipedia.org/wiki/%E3%83%AC%E3%83%8B%E3%83%B3%E3%82%B0%E3%83%A9%E3%83%BC%E3%83%89%E9%9F%B3%E6%A5%BD%E9%99%A2,0,0,0,0,0
https://web.archive.org/web/20120123172935/http://www.futeko.com/navpage/media-players.php,0,0,0,0,0
https://web.archive.org/web/20120123054531/http://www.iboum.com/pr/poppst30.php,0,0,0,0,0
https://uk.wikipedia.org/wiki/%D0%A8%D1%80%D0%B8%D0%B2%D1%96%D0%B4%D0%B6%D0%B0%D1%8F,0,0,0,0,0
https://web.archive.org/web/20120123122404/http://www.iboum.com/pr/blue3550.php,0,0,0,0,0
https://web.archive.org/web/20120123122404/http://www.iboum.com/pr/eagetm90.php,0,0,0,0,0
https://ja.wikipedia.org/wiki/%E3%83%A2%E3%83%AA%E3%82%B9%E3%82%B3,0,0,0,0,0
https://uk.wikipedia.org/wiki/%D0%9A%D0%BE%D1%80%D0%B0%D0%BD,0,0,0,0,0
https://ja.wikipedia.org/wiki/%E3%82%B9%E3%83%BC%E3%83%95%E3%82%A3%E3%82%BA%E3%83%A0,0,0,0,0,0
https://web.archive.org/web/20120123162217/http://www.iboum.com/pr/him600a.php,0,0,0,0,0
https://web.archive.org/web/20120123172935/http://www.iboum.com/pr/eaget850.php,0,0,0,0,0
https://web.archive.org/web/20120123172935/http://www.iboum.com/pr/kai355i.php,0,0,0,0,0
https://web.archive.org/web/20120123054531/http://www.iboum.com/pr/iomegdx.php,0,0,0,0,0
https://web.archive.org/web/20120123054531/http://www.iboum.com/pr/terr520.php,0,0,0,0,0
https://web.archive.org/web/20120123162217/http://www.iboum.com/pr/egr150.php,0,0,0,0,0
https://web.archive.org/web/20101224214353/http://www.iboum.com:80/pr/icon4sl.php,0,0,0,0,0
https://web.archive.org/web/20120123172935/http://www.iboum.com/pr/dxd1.php,0,0,0,0,0
https://web.archive.org/web/20120123054531/http://www.iboum.com/pr/storslim.php,0,0,0,0,0
https://web.archive.org/web/20120123162217/http://www.iboum.com/pr/noona6powerp.php,0,0,0,0,0
https://web.archive.org/web/20120123162217/http://www.iboum.com/pr/ol3hd.php,0,0,0,0,0
https://web.archive.org/web/20120123054531/http://www.iboum.com/pr/dune301.php,0,0,0,0,0
https://web.archive.org/web/20120123122404/http://www.iboum.com/pr/him600b.php,0,0,0,0,0
https://de.wikipedia.org/wiki/Stahlguss,0,0,0,0,0
https://web.archive.org/web/20120123054531/http://www.iboum.com/pr/itab48r.php,0,0,0,0,0
https://ja.wikipedia.org/wiki/%E3%82%A6%E3%83%A9%E3%83%9E%E3%83%BC,0,0,0,0,0
https://uk.wikipedia.org/wiki/%D0%9F%D0%B0%D0%BF%D0%B5%D1%80%D0%BE%D0%B2%D1%96_%D0%B3%D1%80%D0%BE%D1%88%D1%96,0,0,0,0,0
https://web.archive.org/web/20120123054531/http://www.iboum.com/pr/olevia530.php,0,0,0,0,0
https://web.archive.org/web/20120123172935/http://www.iboum.com/,0,0,0,0,0
https://web.archive.org/web/20120123172935/http://www.iboum.com/pr/seagoflex.php,0,0,0,0,0
https://web.archive.org/web/20120123122404/http://www.iboum.com/pr/d-pebble.php,0,0,0,0,0
https://web.archive.org/web/20120123172935/http://www.iboum.com/pr/PH100.php,0,0,0,0,0
https://web.archive.org/web/20120123054531/http://www.iboum.com/pr/pop35.php,0,0,0,0,0
https://web.archive.org/web/20120123122404/http://www.iboum.com/pr/brplay.php,0,0,0,0,0
https://ja.wikipedia.org/wiki/%E3%83%8F%E3%83%87%E3%82%A3%E3%83%BC%E3%82%B8%E3%83%A3%E3%83%BB%E3%83%93%E3%83%B3%E3%83%88%E3%83%BB%E3%83%95%E3%83%AF%E3%82%A4%E3%83%AA%E3%83%89,0,0,0,0,0
https://web.archive.org/web/20120123162217/http://www.iboum.com/pr/med85015.php,0,0,0,0,0
https://de.wikipedia.org/wiki/Silizium,0,0,0,0,0
https://web.archive.org/web/20120123172935/http://www.iboum.com/pr/astone100.php,0,0,0,0,0
https://web.archive.org/web/20120123054531/http://www.iboum.com/pr/seagateplus.php,0,0,0,0,0
https://web.archive.org/web/20120123054531/http://www.iboum.com/pr/egr180.php,0,0,0,0,0
https://web.archive.org/web/20120123122404/http://www.iboum.com/pr/view75.php,0,0,0,0,0
https://web.archive.org/web/20120123172935/http://www.iboum.com/pr/view73.php,0,0,0,0,0
https://web.archive.org/web/20120123162217/http://www.iboum.com/pr/em7297.php,0,0,0,0,0
https://mrj.wikipedia.org/wiki/668_%D0%B8,0,0,0,0,0
https://uk.wikipedia.org/wiki/%D0%97%D0%BE%D1%80%D0%BE%D0%B0%D1%81%D1%82%D1%80%D0%B8%D0%B7%D0%BC,0,0,0,0,0
https://web.archive.org/web/20120123054531/http://www.iboum.com/pr/lacla.php,0,0,0,0,0
https://web.archive.org/web/20120123162217/http://www.iboum.com/pr/mykam.php,0,0,0,0,0
https://web.archive.org/web/20120123162217/http://www.iboum.com/pr/ellion500.php,0,0,0,0,0
https://az.wikipedia.org/wiki/Abraziv_material,0,0,0,0,0
https://web.archive.org/web/20120123162217/http://www.iboum.com/pr/egr900.php,0,0,0,0,0
https://web.archive.org/web/20120123122404/http://www.iboum.com/pr/rokuxd.php,0,0,0,0,0
https://br.wikipedia.org/wiki/Umar,0,0,0,0,0
https://web.archive.org/web/20120123054531/http://www.iboum.com/pr/eagetm70.php,0,0,0,0,0
https://web.archive.org/web/20120123172935/http://www.iboum.com/pr/stormytv.php,0,0,0,0,0
https://web.archive.org/web/20120123172935/http://www.iboum.com/pr/WDTV2-LIVE-PLUS.php,0,0,0,0,0
https://ja.wikipedia.org/wiki/Category:668%E5%B9%B4,0,0,0,0,0
https://web.archive.org/web/20120123122404/http://www.iboum.com/pr/egr6a2.php,0,0,0,0,0
https://web.archive.org/web/20120123122404/http://www.iboum.com/pr/tvixs1.php,0,0,0,0,0
https://th.wikipedia.org/wiki/%E0%B8%9E.%E0%B8%A8._1211,0,0,0,0,0
https://web.archive.org/web/20120123122404/http://www.iboum.com/pr/egs800.php,0,0,0,0,0
https://web.archive.org/web/20120123054531/http://www.iboum.com/pr/sarot6b.php,0,0,0,0,0
https://web.archive.org/web/20120123172935/http://www.iboum.com/pr/mediavx.php,0,0,0,0,0
https://web.archive.org/web/20120123122404/http://www.iboum.com/pr/qnap1000.php,0,0,0,0,0
https://ja.wikipedia.org/wiki/%E3%82%A2%E3%83%BC%E3%82%A4%E3%82%B7%E3%83%A3%E3%83%BB%E3%83%93%E3%83%B3%E3%83%88%E3%83%BB%E3%82%A2%E3%83%96%E3%83%BC%E3%83%BB%E3%83%90%E3%82%AF%E3%83%AB,0,0,0,0,0
https://web.archive.org/web/20120123054531/http://www.iboum.com/,0,0,0,0,0
https://web.archive.org/web/20120123054531/http://www.iboum.com/pr/bolmob.php,0,0,0,0,0
https://web.archive.org/web/20120123162217/http://www.iboum.com/pr/him900c.php,0,0,0,0,0
https://ga.wikipedia.org/wiki/Scr%C3%ADobach,0,0,0,0,0
https://web.archive.org/web/20120123162217/http://www.iboum.com/pr/sumcycpr.php,0,0,0,0,0
https://web.archive.org/web/20120123054531/http://www.iboum.com/pr/hdium1.php,0,0,0,0,0
https://web.archive.org/web/20120123172935/http://www.iboum.com/pr/met322.php,0,0,0,0,0
https://web.archive.org/web/20120123122404/http://www.iboum.com/pr/novad29.php,0,0,0,0,0
https://web.archive.org/web/20120123162217/http://www.iboum.com/pr/fanttv.php,0,0,0,0,0
https://web.archive.org/web/20120123162217/http://www.iboum.com/pr/egreatr6a.php,0,0,0,0,0
https://uk.wikipedia.org/wiki/8_%D1%81%D1%82%D0%BE%D0%BB%D1%96%D1%82%D1%82%D1%8F,0,0,0,0,0
https://ja.wikipedia.org/wiki/Category:668%E5%B9%B4%E7%94%9F,0,0,0,0,0
https://web.archive.org/web/20120123122404/http://www.iboum.com/pr/em7180.php,0,0,0,0,0
https://web.archive.org/web/20120123172935/http://www.iboum.com/pr/imation.php,0,0,0,0,0
https://web.archive.org/web/20120123162217/http://www.iboum.com/pr/myga3n.php,0,0,0,0,0
https://web.archive.org/web/20120123122404/http://www.iboum.com/pr/dune301.php,0,0,0,0,0
https://de.wikipedia.org/wiki/Datei:Fepa-standard.png,0,0,0,0,0
https://web.archive.org/web/20120126040332/http://www.iboum.com/pr/howh3.php,0,0,0,0,0
https://web.archive.org/web/20120123165243/http://www.iboum.com/pr/kaih1055.php,0,0,0,0,0
https://web.archive.org/web/20120123170010/http://www.iboum.com/pr/howu6.php,0,0,0,0,0
https://web.archive.org/web/20120123013059/http://www.iboum.com/pr/ellion500.php,0,0,0,0,0
https://web.archive.org/web/20120123043741/http://www.iboum.com/pr/NBOX.php,0,0,0,0,0
https://web.archive.org/web/20120123150451/http://www.iboum.com/pr/ideri9.php,0,0,0,0,0
https://web.archive.org/web/20120123022233/http://www.iboum.com/pr/terr740.php,0,0,0,0,0
https://web.archive.org/web/20120123161920/http://www.iboum.com/pr/fan3700.php,0,0,0,0,0
https://web.archive.org/web/20120123014126/http://www.iboum.com/pr/yangh2.php,0,0,0,0,0
https://web.archive.org/web/20120123140759/http://www.iboum.com/pr/miccmplay.php,0,0,0,0,0
https://web.archive.org/web/20120123132913/http://www.iboum.com/pr/iomegdx.php,0,0,0,0,0
https://web.archive.org/web/20120123145455/http://www.iboum.com/pr/tvixs1.php,0,0,0,0,0
https://web.archive.org/web/20120123034959/http://www.iboum.com/pr/giec120.php,0,0,0,0,0
https://uk.wikipedia.org/wiki/%D0%A4%D0%B0%D0%B9%D0%BB:Tyurki.jpg,0,0,0,0,0
https://uk.wikipedia.org/wiki/%D0%9F%D0%B5%D1%80%D1%81%D1%96%D1%8F,0,0,0,0,0
https://web.archive.org/web/20120123175839/http://www.iboum.com/pr/acplayhdm.php,0,0,0,0,0
https://web.archive.org/web/20120127062505/http://www.iboum.com/pr/view75.php,0,0,0,0,0
https://web.archive.org/web/20120123153855/http://www.iboum.com/pr/micca950.php,0,0,0,0,0
https://web.archive.org/web/20120123050311/http://www.iboum.com/pr/amex510.php,0,0,0,0,0
https://web.archive.org/web/20120123133418/http://www.iboum.com/pr/ariva210.php,0,0,0,0,0
https://web.archive.org/web/20120123153855/http://www.iboum.com/pr/ent2000.php,0,0,0,0,0
https://web.archive.org/web/20120123133418/http://www.iboum.com/pr/em7280.php,0,0,0,0,0
https://uk.wikipedia.org/wiki/%D0%90%D1%80%D0%B0%D0%BC%D0%B5%D0%B9%D1%81%D1%8C%D0%BA%D0%B0_%D0%BC%D0%BE%D0%B2%D0%B0,0,0,0,0,0
https://web.archive.org/web/20120123192007/http://www.iboum.com/pr/sumlive.php,0,0,0,0,0
https://web.archive.org/web/20120123124834/http://www.iboum.com/pr/ol4hd.php,0,0,0,0,0
https://web.archive.org/web/20120123015924/http://www.iboum.com/pr/dopodo2000.php,0,0,0,0,0
https://web.archive.org/web/20120123015924/http://www.iboum.com/pr/allurem3.php,0,0,0,0,0
https://web.archive.org/web/20120123192007/http://www.iboum.com/pr/sage200.php,0,0,0,0,0
https://web.archive.org/web/20120123124834/http://www.iboum.com/pr/m2tvd.php,0,0,0,0,0
https://web.archive.org/web/20120123153855/http://www.iboum.com/pr/emk220h.php,0,0,0,0,0
https://web.archive.org/web/20120123153855/http://www.iboum.com/pr/seagateplus.php,0,0,0,0,0
https://web.archive.org/web/20120123015924/http://www.iboum.com/links.php,0,0,0,0,0
https://web.archive.org/web/20120123133418/http://www.iboum.com/pr/med300.php,0,0,0,0,0
https://web.archive.org/web/20120123133418/http://www.iboum.com/pr/eagetx5.php,0,0,0,0,0
https://web.archive.org/web/20120123124834/http://www.iboum.com/pr/egreata1080.php,0,0,0,0,0
https://web.archive.org/web/20120123192007/http://www.iboum.com/pr/egreatr3a.php,0,0,0,0,0
https://web.archive.org/web/20120123133418/http://www.iboum.com/pr/hisense800.php,0,0,0,0,0
https://web.archive.org/web/20120123124834/http://www.iboum.com/pr/howh3.php,0,0,0,0,0
https://web.archive.org/web/20120123133418/http://www.iboum.com/pr/howu6.php,0,0,0,0,0
https://web.archive.org/web/20120126124427/http://www.iboum.com/pr/netgear-neo-350.php,0,0,0,0,0
https://web.archive.org/web/20120123153855/http://www.iboum.com/pr/giec230.php,0,0,0,0,0
https://web.archive.org/web/20120123015924/http://www.iboum.com/pr/xtelv.php,0,0,0,0,0
https://web.archive.org/web/20120123133418/http://www.iboum.com/pr/sumcyclone.php,0,0,0,0,0
https://uk.wikipedia.org/wiki/276,0,0,0,0,0
https://web.archive.org/web/20120123133418/http://www.iboum.com/pr/ph3000.php,0,0,0,0,0
https://uk.wikipedia.org/wiki/272,0,0,0,0,0
https://web.archive.org/web/20120126124427/http://www.iboum.com/pr/blue3584.php,0,0,0,0,0
https://web.archive.org/web/20120126124427/http://www.iboum.com/pr/egr2002.php,0,0,0,0,0
https://web.archive.org/web/20120123124834/http://www.iboum.com/pr/ferg310.php,0,0,0,0,0
https://web.archive.org/web/20120123192007/http://www.iboum.com/pr/kai210.php,0,0,0,0,0
https://web.archive.org/web/20120123133418/http://www.iboum.com/pr/egr180.php,0,0,0,0,0
https://web.archive.org/web/20120123124834/http://www.iboum.com/pr/kwm200.php,0,0,0,0,0
https://web.archive.org/web/20120123015924/http://www.iboum.com/pr/yangh2.php,0,0,0,0,0
https://web.archive.org/web/20120123050311/http://www.iboum.com/pr/goto5100.php,0,0,0,0,0
https://web.archive.org/web/20120123133418/http://www.iboum.com/pr/kai750.php,0,0,0,0,0
https://web.archive.org/web/20120123192007/http://www.iboum.com/pr/evo311.php,0,0,0,0,0
https://web.archive.org/web/20120123192007/http://www.iboum.com/pr/NBOX.php,0,0,0,0,0
https://uk.wikipedia.org/wiki/%D0%95%D0%BA%D0%B1%D0%B0%D1%82%D0%B0%D0%BD%D0%B0,0,0,0,0,0
https://web.archive.org/web/20120126124427/http://www.iboum.com/pr/icon52.php,0,0,0,0,0
https://web.archive.org/web/20120123050311/http://www.iboum.com/pr/cirago1000.php,0,0,0,0,0
https://web.archive.org/web/20120123050311/http://www.iboum.com/pr/melem01.php,0,0,0,0,0
https://web.archive.org/web/20120123192007*/http://www.iboum.com/pr/giec120.php,0,0,0,0,0
https://web.archive.org/web/20120123192007/http://www.iboum.com/pr/wdtvlive11.php,0,0,0,0,0
https://web.archive.org/web/20120123133418/http://www.iboum.com/pr/hdx2000.php,0,0,0,0,0
https://web.archive.org/web/20120123153855/http://www.iboum.com/pr/bevix6058.php,0,0,0,0,0
https://web.archive.org/web/20120123133418/http://www.iboum.com/pr/asia1.php,0,0,0,0,0
https://web.archive.org/web/20120123015924/http://www.iboum.com/pr/ferg310.php,0,0,0,0,0
https://uk.wikipedia.org/wiki/%D0%9B%D1%83%D1%80%D0%B8%D1%81%D1%82%D0%B0%D0%BD,0,0,0,0,0
https://web.archive.org/web/20120123124834/http://www.iboum.com/pr/ast300t.php,0,0,0,0,0
https://web.archive.org/web/20120123153855/http://www.iboum.com/pr/xentaav.php,0,0,0,0,0
https://web.archive.org/web/20120123153855/http://www.iboum.com/pr/met322.php,0,0,0,0,0
https://web.archive.org/web/20120123050311/http://www.iboum.com/pr/patbcore.php,0,0,0,0,0
https://web.archive.org/web/20120126124427/http://www.iboum.com/pr/verbmdvr.php,0,0,0,0,0
https://web.archive.org/web/20120123153855/http://www.iboum.com/pr/enc211.php,0,0,0,0,0
https://uk.wikipedia.org/wiki/%D0%9A%D0%B0%D0%BC%D0%B1%D1%96%D0%B7_I,0,0,0,0,0
https://web.archive.org/web/20120123050311/http://www.iboum.com/pr/med85015.php,0,0,0,0,0
https://web.archive.org/web/20120126124427/http://www.iboum.com/,0,0,0,0,0
https://web.archive.org/web/20120123133418/http://www.iboum.com/pr/bolmob.php,0,0,0,0,0
https://web.archive.org/web/20120123153855/http://www.iboum.com/pr/sage300.php,0,0,0,0,0
https://web.archive.org/web/20120123015924/http://www.iboum.com/pr/ast300t.php,0,0,0,0,0
https://web.archive.org/web/20120123153855/http://www.iboum.com/pr/hdx-bone.php,0,0,0,0,0
https://web.archive.org/web/20120123133418/http://www.iboum.com/pr/hdium1.php,0,0,0,0,0
https://web.archive.org/web/20120123153855/http://www.iboum.com/pr/sumcycmicro.php,0,0,0,0,0
https://web.archive.org/web/20120123192007/http://www.iboum.com/pr/icy3010.php,0,0,0,0,0
https://web.archive.org/web/20120123015924/http://www.iboum.com/pr/wdtv-elephant-play.php,0,0,0,0,0
https://web.archive.org/web/20120123124834/http://www.iboum.com/pr/eyef10.php,0,0,0,0,0
https://web.archive.org/web/20120123050311/http://www.iboum.com/pr/egr2002.php,0,0,0,0,0
https://web.archive.org/web/20120123153855/http://www.iboum.com/index.php,0,0,0,0,0
https://web.archive.org/web/20120126124427/http://www.iboum.com/pr/wdtvliveh.php,0,0,0,0,0
https://web.archive.org/web/20120123133418/http://www.iboum.com/pr/bevix6010.php,0,0,0,0,0
https://web.archive.org/web/20120126124427/http://www.iboum.com/pr/darkmm.php,0,0,0,0,0
https://web.archive.org/web/20120123133418/http://www.iboum.com/pr/myga3.php,0,0,0,0,0
https://web.archive.org/web/20120123050311/http://www.iboum.com/pr/dune-smart-h1.php,0,0,0,0,0
https://web.archive.org/web/20120123153855/http://www.iboum.com/pr/storslim.php,0,0,0,0,0
https://web.archive.org/web/20120123015924/http://www.iboum.com/pr/egreatr4b.php,0,0,0,0,0
https://web.archive.org/web/20120123133418/http://www.iboum.com/pr/goto5100.php,0,0,0,0,0
https://web.archive.org/web/20120123192007/http://www.iboum.com/pr/gmin895.php,0,0,0,0,0
https://web.archive.org/web/20120123153855/http://www.iboum.com/pr/med5x2.php,0,0,0,0,0
https://web.archive.org/web/20120123124834/http://www.iboum.com/pr/egr200.php,0,0,0,0,0
https://web.archive.org/web/20120123153855/http://www.iboum.com/pr/roku2xs.php,0,0,0,0,0
https://web.archive.org/web/20120123192007/http://www.iboum.com/pr/hornetshow.php,0,0,0,0,0
https://web.archive.org/web/20120123192007/http://www.iboum.com/pr/measyx7.php,0,0,0,0,0
https://web.archive.org/web/20120123133418/http://www.scripts.oldguy.us/,0,0,0,0,0
https://web.archive.org/web/20120123192007/http://www.iboum.com/pr/icy312.php,0,0,0,0,0
https://web.archive.org/web/20120126124427/http://www.iboum.com/pr/fan3600.php,0,0,0,0,0
https://web.archive.org/web/20120123124834/http://www.iboum.com/pr/seagoflex.php,0,0,0,0,0
https://web.archive.org/web/20120123124834/http://www.iboum.com/pr/fan2300.php,0,0,0,0,0
https://web.archive.org/web/20120123133418/http://www.iboum.com/pr/avextreme.php,0,0,0,0,0
https://web.archive.org/web/20120123124834/http://www.iboum.com/pr/wdtvlive11.php,0,0,0,0,0
https://web.archive.org/web/20120123153855/http://www.iboum.com/pr/noonv8p.php,0,0,0,0,0
https://web.archive.org/web/20120123192007/http://www.iboum.com/pr/lenlhd76.php,0,0,0,0,0
https://web.archive.org/web/20120123124834/http://www.iboum.com/pr/qnap1000p.php,0,0,0,0,0
https://commons.wikimedia.org/wiki/Template:PD-Art/diq,0,0,0,0,0
https://web.archive.org/web/20120123050311/http://www.iboum.com/pr/ibox400.php,0,0,0,0,0
https://web.archive.org/web/20120123192007/http://www.iboum.com/pr/patriot.php,0,0,0,0,0
https://web.archive.org/web/20120123153855/http://www.iboum.com/pr/meleg02.php,0,0,0,0,0
https://web.archive.org/web/20120123124834/http://www.iboum.com/pr/datm1.php,0,0,0,0,0
https://web.archive.org/web/20120123124834/http://www.iboum.com/pr/howv3.php,0,0,0,0,0
https://web.archive.org/web/20120123153855/http://www.iboum.com/pr/wdtvlive11.php,0,0,0,0,0
https://web.archive.org/web/20120123192007/http://www.iboum.com/pr/XTREAMERPRO.php,0,0,0,0,0
https://web.archive.org/web/20120123124834/http://www.iboum.com/pr/him560b.php,0,0,0,0,0
https://web.archive.org/web/20120123124834/http://www.iboum.com/pr/fan2550.php,0,0,0,0,0
https://web.archive.org/web/20141223033523/http://www.iboum.com:80/pr/NBOX.php,0,0,0,0,0
https://uk.wikipedia.org/wiki/%D0%A1%D0%B0%D1%82%D1%80%D0%B0%D0%BF,0,0,0,0,0
https://web.archive.org/web/20120123191902/http://www.iboum.com/pr/sumcyclone.php,0,0,0,0,0
https://uk.wikipedia.org/wiki/%D0%95%D0%BF%D0%BE%D1%81_%D0%BF%D1%80%D0%BE_%D0%93%D1%96%D0%BB%D1%8C%D0%B3%D0%B0%D0%BC%D0%B5%D1%88%D0%B0,0,0,0,0,0
https://web.archive.org/web/20120123052023/http://www.iboum.com/pr/astone100.php,0,0,0,0,0
https://web.archive.org/web/20120123175854/http://www.iboum.com/pr/egr2002.php,0,0,0,0,0
https://web.archive.org/web/20120126121402/http://www.iboum.com/pr/em7195.php,0,0,0,0,0
https://web.archive.org/web/20120127033107/http://www.iboum.com/pr/egreata1080.php,0,0,0,0,0
https://web.archive.org/web/20120123051512/http://www.iboum.com/pr/icon7l.php,0,0,0,0,0
https://web.archive.org/web/20120123142840/http://www.iboum.com/pr/kai860i.php,0,0,0,0,0
https://web.archive.org/web/20120126121402/http://www.iboum.com/pr/kodakt1.php,0,0,0,0,0
https://web.archive.org/web/20120127062442/http://www.iboum.com/pr/fantech-fhdl.php,0,0,0,0,0
https://web.archive.org/web/20141223033523/http://www.iboum.com/pr/miccamhd.php,0,0,0,0,0
https://web.archive.org/web/20120123021854/http://www.iboum.com/pr/kai580.php,0,0,0,0,0
https://web.archive.org/web/20141223033523/http://www.iboum.com/pr/ottcs928.php,0,0,0,0,0
https://web.archive.org/web/20120123144423/http://www.iboum.com/,0,0,0,0,0
https://web.archive.org/web/20120123023743/http://www.iboum.com/pr/roku2hd.php,0,0,0,0,0
https://web.archive.org/web/20120123160538/http://www.iboum.com/pr/kai580i.php,0,0,0,0,0
https://uk.wikipedia.org/wiki/%D0%90%D1%81%D1%81%D0%B8%D1%80%D0%BE%D0%BB%D0%BE%D0%B3%D1%96%D1%8F,0,0,0,0,0
https://web.archive.org/web/20120127053118/http://www.iboum.com/pr/patriot.php,0,0,0,0,0
https://web.archive.org/web/20120123052023/http://www.iboum.com/pr/genand1.php,0,0,0,0,0
https://web.archive.org/web/20120123030820/http://www.iboum.com/pr/astone200.php,0,0,0,0,0
https://web.archive.org/web/20120123051512/http://www.iboum.com/pr/net2000live.php,0,0,0,0,0
https://web.archive.org/web/20120127062442/http://www.iboum.com/pr/wdtv-elephant-play.php,0,0,0,0,0
https://web.archive.org/web/20120123040810/http://www.iboum.com/pr/fan2750.php,0,0,0,0,0
https://web.archive.org/web/20120123032508/http://www.iboum.com/pr/tvroid.php,0,0,0,0,0
https://web.archive.org/web/20120127011947/http://www.iboum.com/pr/myga3.php,0,0,0,0,0
https://web.archive.org/web/20120123144322/http://www.iboum.com/pr/med85015.php,0,0,0,0,0
https://web.archive.org/web/20120123051512/http://www.iboum.com/net-media-players.php,0,0,0,0,0
https://web.archive.org/web/20120123191902/http://www.iboum.com/pr/terr520.php,0,0,0,0,0
https://web.archive.org/web/20120123043713/http://www.iboum.com/pr/med4x2.php,0,0,0,0,0
https://web.archive.org/web/20120127053319/http://www.iboum.com/pr/egreatr4b.php,0,0,0,0,0
https://web.archive.org/web/20120127053319/http://www.iboum.com/pr/xentamkv.php,0,0,0,0,0
https://web.archive.org/web/20120123060243/http://www.statcounter.com/wordpress.org/,0,0,0,0,0
https://web.archive.org/web/20120123163015/http://www.iboum.com/pr/sage300.php,0,0,0,0,0
https://web.archive.org/web/20120123112311/http://www.iboum.com/pr/egs800.php,0,0,0,0,0
https://web.archive.org/web/20120123191902/http://www.iboum.com/pr/mvult.php,0,0,0,0,0
https://web.archive.org/web/20120123160538/http://www.iboum.com/pr/view74.php,0,0,0,0,0
https://web.archive.org/web/20120123112311/http://www.iboum.com/pr/iomegplus.php,0,0,0,0,0
https://web.archive.org/web/20120123172844/http://www.iboum.com/pr/fanalup.php,0,0,0,0,0
https://web.archive.org/web/20120123040810/http://www.iboum.com/pr/diyoxs.php,0,0,0,0,0
https://web.archive.org/web/20120123030820/http://www.iboum.com/pr/datm1.php,0,0,0,0,0
https://web.archive.org/web/20120123032508/http://www.iboum.com/pr/fan3d.php,0,0,0,0,0
https://web.archive.org/web/20120123052328/http://www.iboum.com/pr/summic2.php,0,0,0,0,0
https://web.archive.org/web/20120123032508/http://www.iboum.com/pr/emk230.php,0,0,0,0,0
https://web.archive.org/web/20120123023743/http://www.iboum.com/pr/dune.php,0,0,0,0,0
https://web.archive.org/web/20120123164846/http://www.iboum.com/pr/lenlhd76.php,0,0,0,0,0
https://web.archive.org/web/20120123131249/http://www.iboum.com/pr/sage300.php,0,0,0,0,0
https://web.archive.org/web/20120123124845/http://www.iboum.com/pr/datageHD.php,0,0,0,0,0
https://web.archive.org/web/20120123040810/http://www.iboum.com/pr/egreatr2a.php,0,0,0,0,0
https://web.archive.org/web/20120123124845/http://www.iboum.com/pr/cirago1000.php,0,0,0,0,0
https://web.archive.org/web/20120123023743/http://www.iboum.com/pr/seagateplus.php,0,0,0,0,0
https://web.archive.org/web/20120123112311/http://www.iboum.com/pr/dx320.php,0,0,0,0,0
https://web.archive.org/web/20120127053118/http://www.iboum.com/pr/fan2300.php,0,0,0,0,0
https://web.archive.org/web/20120123124845/http://www.iboum.com/pr/egreatr2a.php,0,0,0,0,0
https://uk.wikipedia.org/wiki/%D0%A4%D0%B0%D0%B9%D0%BB:Tomb_of_Imamzadeh_Ja%27far.jpg,0,0,0,0,0
https://web.archive.org/web/20120123164846/http://www.iboum.com/pr/egr200s.php,0,0,0,0,0
https://web.archive.org/web/20120123142840/http://www.iboum.com/pr/bevix8078.php,0,0,0,0,0
https://web.archive.org/web/20120126121402/http://www.iboum.com/pr/kai210.php,0,0,0,0,0
https://web.archive.org/web/20120127062442/http://www.iboum.com/pr/datastor.php,0,0,0,0,0
https://web.archive.org/web/20120126160240/http://www.iboum.com/pr/nixfs.php,0,0,0,0,0
https://web.archive.org/web/20120126121402/http://www.iboum.com/pr/d-pebble.php,0,0,0,0,0
https://web.archive.org/web/20120123172844/http://www.iboum.com/pr/iomegspd.php,0,0,0,0,0
https://web.archive.org/web/20120123175854/http://www.iboum.com/artkill/hd-audio-media-players.php,0,0,0,0,0
https://web.archive.org/web/20120123165008/http://www.iboum.com/pr/netgear-neo-350.php,0,0,0,0,0
https://web.archive.org/web/20120123163050/http://www.iboum.com/pr/kodakt1.php,0,0,0,0,0
https://web.archive.org/web/20120127062702/http://www.iboum.com/pr/icy311.php,0,0,0,0,0
https://web.archive.org/web/20120123023743/http://www.iboum.com/pr/novad83.php,0,0,0,0,0
https://web.archive.org/web/20120123021854/http://www.iboum.com/pr/egreatr4b.php,0,0,0,0,0
https://web.archive.org/web/20120123163050/http://www.iboum.com/pr/ariva210.php,0,0,0,0,0
https://web.archive.org/web/20120123172844/http://www.iboum.com/pr/ASUSO-AIR.php,0,0,0,0,0
https://web.archive.org/web/20120123105805/http://www.iboum.com/pr/summic2p.php,0,0,0,0,0
https://web.archive.org/web/20120123035315/http://www.iboum.com/pr/freexs.php,0,0,0,0,0
https://web.archive.org/web/20120127062442/http://www.iboum.com/pr/kai320.php,0,0,0,0,0
https://web.archive.org/web/20120123105805/http://www.iboum.com/pr/eyef10.php,0,0,0,0,0
https://web.archive.org/web/20120127053118/http://www.iboum.com/artkill/chipsets.php,0,0,0,0,0
https://web.archive.org/web/20141223033523/http://www.iboum.com/pr/compro1000.php,0,0,0,0,0
https://web.archive.org/web/20120123023743/http://www.iboum.com/pr/sumcycmicro.php,0,0,0,0,0
https://web.archive.org/web/20120123172844/http://www.iboum.com/pr/toshstv.php,0,0,0,0,0
https://web.archive.org/web/20120123104032/http://www.iboum.com/pr/view70.php,0,0,0,0,0
https://web.archive.org/web/20120123131249/http://www.iboum.com/pr/kwm200.php,0,0,0,0,0
https://web.archive.org/web/20120123142840/http://www.iboum.com/pr/dxd1.php,0,0,0,0,0
https://web.archive.org/web/20120126160240/http://www.iboum.com/pr/giec120.php,0,0,0,0,0
https://web.archive.org/web/20120123131249/mailto:mail@iboum.com,0,0,0,0,0
https://web.archive.org/web/20120123040810/http://www.iboum.com/pr/ellion500.php,0,0,0,0,0
https://web.archive.org/web/20120123163050/http://www.iboum.com/pr/ibewan.php,0,0,0,0,0
https://web.archive.org/web/20120123030820/http://www.iboum.com/pr/miccmplay.php,0,0,0,0,0
https://web.archive.org/web/20120123131249/http://www.iboum.com/pr/him200b.php,0,0,0,0,0
https://web.archive.org/web/20120123142040/http://www.iboum.com/pr/pico51.php,0,0,0,0,0
https://web.archive.org/web/20120123043713/http://www.iboum.com/pr/qnap1000p.php,0,0,0,0,0
https://web.archive.org/web/20120126160240/http://www.iboum.com/pr/lacla.php,0,0,0,0,0
https://web.archive.org/web/20120123032508/http://www.iboum.com/pr/egreats1a.php,0,0,0,0,0
https://web.archive.org/web/20120123131249/http://www.iboum.com/pr/ellion500.php,0,0,0,0,0
https://web.archive.org/web/20120123043713/http://www.iboum.com/bloog/,0,0,0,0,0
https://web.archive.org/web/20120123012753/http://www.iboum.com/net-media-players.php,0,0,0,0,0
https://web.archive.org/web/20120123051512/http://www.iboum.com/pr/ol3hd.php,0,0,0,0,0
https://web.archive.org/web/20120123163015/http://www.iboum.com/pr/enc211.php,0,0,0,0,0
https://web.archive.org/web/20120123021854/http://www.iboum.com/pr/sumlive.php,0,0,0,0,0
https://web.archive.org/web/20120123040810/http://www.iboum.com/pr/tvix7000.php,0,0,0,0,0
https://web.archive.org/web/20120123131249/http://www.iboum.com/pr/zaggbox.php,0,0,0,0,0
https://web.archive.org/web/20120127053118/http://www.iboum.com/pr/popbox.php,0,0,0,0,0
https://web.archive.org/web/20120127062702*/http://www.iboum.com/pr/amex510.php,0,0,0,0,0
https://web.archive.org/web/20120123051512/http://www.iboum.com/pr/icon4sl.php,0,0,0,0,0
https://web.archive.org/web/20120123021854/http://www.iboum.com/pr/rokuxd.php,0,0,0,0,0
https://web.archive.org/web/20120123142040/http://www.iboum.com/pr/egreatrm1.php,0,0,0,0,0
https://web.archive.org/web/20120123142840/http://www.iboum.com/pr/egreats1a.php,0,0,0,0,0
https://web.archive.org/web/20120123184940/http://www.iboum.com/pr/fanalup.php,0,0,0,0,0
https://web.archive.org/web/20120123025512/http://www.iboum.com/pr/dx390.php,0,0,0,0,0
https://web.archive.org/web/20120123012753/http://www.iboum.com/pr/him600c.php,0,0,0,0,0
https://web.archive.org/web/20120123043713/http://www.iboum.com/pr/musicb200.php,0,0,0,0,0
https://web.archive.org/web/20120123023743/http://www.iboum.com/pr/tizzf30.php,0,0,0,0,0
https://web.archive.org/web/20120127053118/http://www.iboum.com/pr/bevix8078.php,0,0,0,0,0
https://web.archive.org/web/20120123105805/http://www.iboum.com/pr/him900a.php,0,0,0,0,0
https://web.archive.org/web/20120127060733/http://www.iboum.com/pr/kai360i.php,0,0,0,0,0
https://web.archive.org/web/20120123060243/http://www.iboum.com/pr/tvix7000.php,0,0,0,0,0
https://web.archive.org/web/20120127062442/http://www.iboum.com/pr/him560b.php,0,0,0,0,0
https://web.archive.org/web/20120123142840/http://www.iboum.com/pr/roku1.php,0,0,0,0,0
https://web.archive.org/web/20120123173125/http://www.iboum.com/pr/netg8000.php,0,0,0,0,0
https://web.archive.org/web/20120127053118/http://www.iboum.com/pr/PH100.php,0,0,0,0,0
https://web.archive.org/web/20120123171506/http://www.iboum.com/index.php,0,0,0,0,0
https://web.archive.org/web/20120123060243/http://www.iboum.com/pr/micc250.php,0,0,0,0,0
https://web.archive.org/web/20120123112311/http://www.iboum.com/pr/ellion-labo.php,0,0,0,0,0
https://web.archive.org/web/20120127053118/http://www.iboum.com/pr/eboda500.php,0,0,0,0,0
https://web.archive.org/web/20120123105805/http://www.iboum.com/pr/evosol.php,0,0,0,0,0
https://web.archive.org/web/20120123035315/http://www.iboum.com/pr/netg8000.php,0,0,0,0,0
https://web.archive.org/web/20120123052328/http://www.iboum.com/pr/em200.php,0,0,0,0,0
https://web.archive.org/web/20120123144423/http://www.iboum.com/pr/him600c.php,0,0,0,0,0
https://web.archive.org/web/20120123163015/http://www.iboum.com/pr/WDTV-MK2.php,0,0,0,0,0
https://web.archive.org/web/20120123172844/http://www.iboum.com/pr/ac-playon-dvr.php,0,0,0,0,0
https://web.archive.org/web/20120123142840/http://www.iboum.com/pr/em8100.php,0,0,0,0,0
https://web.archive.org/web/20120123051512/http://www.iboum.com/pr/tvixn1.php,0,0,0,0,0
https://web.archive.org/web/20120123160538/http://www.iboum.com/pr/WDTV2-LIVE.php,0,0,0,0,0
https://web.archive.org/web/20120123060243/http://www.iboum.com/pr/wdtvlive11.php,0,0,0,0,0
https://web.archive.org/web/20141223033523/http://www.iboum.com/pr/genia510.php,0,0,0,0,0
https://web.archive.org/web/20120123052023/http://www.iboum.com/pr/ider201.php,0,0,0,0,0
https://web.archive.org/web/20120127033107/http://www.iboum.com/pr/yangh2.php,0,0,0,0,0
https://web.archive.org/web/20120123191902/http://www.iboum.com/pr/e34a.php,0,0,0,0,0
https://web.archive.org/web/20120123163050/http://www.iboum.com/pr/acplayhdp.php,0,0,0,0,0
https://uk.wikipedia.org/wiki/%D0%A7%D0%BE%D0%B3%D0%B0-%D0%97%D0%B0%D0%BD%D0%B1%D1%96%D0%BB%D1%8C,0,0,0,0,0
https://web.archive.org/web/20120123171506/http://www.myka.tv/,0,0,0,0,0
https://web.archive.org/web/20120123175854/http://www.iboum.com/pr/dia900.php,0,0,0,0,0
https://web.archive.org/web/20120123144423/http://www.iboum.com/pr/howh3.php,0,0,0,0,0
https://web.archive.org/web/20120127060733/http://www.iboum.com/pr/ph5000.php,0,0,0,0,0
https://web.archive.org/web/20120123012753/http://www.iboum.com/pr/kai580i.php,0,0,0,0,0
https://web.archive.org/web/20120127060733/http://www.iboum.com/pr/bright5005.php,0,0,0,0,0
https://web.archive.org/web/20120127053118/http://www.iboum.com/pr/mass1.php,0,0,0,0,0
https://web.archive.org/web/20120127062442/http://www.iboum.com/pr/emtecs800.php,0,0,0,0,0
https://web.archive.org/web/20120127053319/http://www.iboum.com/pr/iomegtvd.php,0,0,0,0,0
https://web.archive.org/web/20120123175854/http://www.iboum.com/pr/fantmini.php,0,0,0,0,0
https://web.archive.org/web/20120123051512/http://www.iboum.com/pr/fansmhub.php,0,0,0,0,0
https://web.archive.org/web/20101229064034/http://www.iboum.com:80/pr/amex510.php,0,0,0,0,0
https://web.archive.org/web/20120123165008/http://www.iboum.com/pr/ideri6fh.php,0,0,0,0,0
https://web.archive.org/web/20120123165008/http://www.iboum.com/pr/kaim1073.php,0,0,0,0,0
https://web.archive.org/web/20120123144322/http://www.iboum.com/pr/howu5.php,0,0,0,0,0
https://web.archive.org/web/20120126121402/http://www.iboum.com/artkill/uservotes.php,0,0,0,0,0
https://web.archive.org/web/20120123012753/http://www.iboum.com/pr/egr500.php,0,0,0,0,0
https://web.archive.org/web/20120121215409/http://www.iboum.com/pr/eyef10.php,0,0,0,0,0
https://web.archive.org/web/20120123184940/http://www.iboum.com/pr/toshstv.php,0,0,0,0,0
https://web.archive.org/web/20120123105805/http://www.iboum.com/pr/lgsmart.php,0,0,0,0,0
https://web.archive.org/web/20120127053118/http://www.iboum.com/pr/pico51.php,0,0,0,0,0
https://web.archive.org/web/20120123191902/http://www.iboum.com/pr/playon.php,0,0,0,0,0
https://web.archive.org/web/20120123165008/http://www.iboum.com/pr/kai1055p.php,0,0,0,0,0
https://web.archive.org/web/20120123040810/http://www.iboum.com/pr/ng9150.php,0,0,0,0,0
https://web.archive.org/web/20120123021854/http://www.iboum.com/pr/gmin895.php,0,0,0,0,0
https://web.archive.org/web/20120125115221/http://www.iboum.com/pr/eyef10.php,0,0,0,0,0
https://web.archive.org/web/20120123124845/http://www.iboum.com/pr/wdtvmini.php,0,0,0,0,0
https://web.archive.org/web/20120127033107/http://www.iboum.com/pr/boxee-box.php,0,0,0,0,0
https://web.archive.org/web/20120123175854/http://www.iboum.com/pr/leaguer1.php,0,0,0,0,0
https://web.archive.org/web/20120123105805/http://www.iboum.com/pr/sumcycpr.php,0,0,0,0,0
https://web.archive.org/web/20120123112311/http://www.iboum.com/pr/dunemax.php,0,0,0,0,0
https://web.archive.org/web/20120127053118/http://www.iboum.com/pr/mediagate.php,0,0,0,0,0
https://web.archive.org/web/20120126121402/http://www.iboum.com/pr/met22.php,0,0,0,0,0
https://web.archive.org/web/20120123142840/http://www.iboum.com/pr/egreatr1.php,0,0,0,0,0
https://web.archive.org/web/20120123043713/http://www.iboum.com/pr/pop35.php,0,0,0,0,0
https://web.archive.org/web/20141223033523/http://www.iboum.com/pr/view74.php,0,0,0,0,0
https://web.archive.org/web/20120123030820/http://www.iboum.com/pr/WDTV2-LIVE.php,0,0,0,0,0
https://web.archive.org/web/20120123191902/http://www.iboum.com/pr/tizzf30.php,0,0,0,0,0
https://web.archive.org/web/20120126160240/http://www.iboum.com/pr/ega1.php,0,0,0,0,0
https://web.archive.org/web/20120123163015/http://www.iboum.com/pr/him600a.php,0,0,0,0,0
https://web.archive.org/web/20141223033523/http://www.iboum.com/pr/brite-cinemago.php,0,0,0,0,0
https://web.archive.org/web/20120123124845/http://www.iboum.com/pr/eagetm6.php,0,0,0,0,0
https://web.archive.org/web/20120123142840/http://www.iboum.com/pr/eageth5.php,0,0,0,0,0
https://web.archive.org/web/20120127054352/http://www.iboum.com/pr/wdtvlive11.php,0,0,0,0,0
https://web.archive.org/web/20120123131249/http://www.iboum.com/pr/imation.php,0,0,0,0,0
https://web.archive.org/web/20120123051512/http://www.iboum.com/pr/icon52.php,0,0,0,0,0
https://web.archive.org/web/20120123131249/http://www.iboum.com/pr/acplayes.php,0,0,0,0,0
https://web.archive.org/web/20120123051512/http://www.iboum.com/pr/cirago1000.php,0,0,0,0,0
https://web.archive.org/web/20120123163015/http://www.iboum.com/pr/zaggbox.php,0,0,0,0,0
https://web.archive.org/web/20120123142840/http://www.iboum.com/pr/med400.php,0,0,0,0,0
https://web.archive.org/web/20120127053118/http://www.iboum.com/pr/sumlive.php,0,0,0,0,0
https://web.archive.org/web/20120123172844/http://www.iboum.com/pr/uebo200.php,0,0,0,0,0
https://web.archive.org/web/20120127062442/http://www.iboum.com/pr/fan2550.php,0,0,0,0,0
https://web.archive.org/web/20120123124845/http://www.iboum.com/pr/ellion500.php,0,0,0,0,0
https://web.archive.org/web/20120123035315/http://www.iboum.com/pr/egreatr3a.php,0,0,0,0,0
https://web.archive.org/web/20120123184940/http://www.iboum.com/pr/xtreamsid2.php,0,0,0,0,0
https://uk.wikipedia.org/wiki/%D0%A6%D0%B8%D0%BB%D1%96%D0%BD%D0%B4%D1%80%D0%B8%D1%87%D0%BD%D0%B0_%D0%BF%D0%B5%D1%87%D0%B0%D1%82%D0%BA%D0%B0,0,0,0,0,0
https://web.archive.org/web/20120123144423/http://www.iboum.com/pr/haup-mvphd.php,0,0,0,0,0
https://web.archive.org/web/20141223033523/http://www.iboum.com/pr/hdium1.php,0,0,0,0,0
https://web.archive.org/web/20120123112311/http://www.iboum.com/pr/kai750li.php,0,0,0,0,0
https://web.archive.org/web/20120123173125/http://www.iboum.com/pr/sage200.php,0,0,0,0,0
https://web.archive.org/web/20120127011947/http://www.iboum.com/pr/emk220h.php,0,0,0,0,0
https://web.archive.org/web/20120127033107/http://www.iboum.com/pr/kai860i.php,0,0,0,0,0
https://web.archive.org/web/20120123030820/http://www.iboum.com/pr/lenlhd80.php,0,0,0,0,0
https://web.archive.org/web/20120123163050/http://www.iboum.com/pr/goto5100.php,0,0,0,0,0
https://web.archive.org/web/20120123144423/http://www.iboum.com/pr/bevix6058.php,0,0,0,0,0
https://web.archive.org/web/20120224133435/http://www.iboum.com/pr/bevix6010.php,0,0,0,0,0
https://web.archive.org/web/20120123052328/http://www.iboum.com/pr/fansmhub.php,0,0,0,0,0
https://web.archive.org/web/20120123040810/http://www.iboum.com/pr/dathdx2.php,0,0,0,0,0
https://web.archive.org/web/20120123035315/http://www.iboum.com/pr/sumcycmicro.php,0,0,0,0,0
https://web.archive.org/web/20120127053044/http://www.iboum.com/pr/novad29.php,0,0,0,0,0
https://web.archive.org/web/20120126215339/http://www.iboum.com/pr/novad82.php,0,0,0,0,0
https://web.archive.org/web/20120123182240/http://www.iboum.com/pr/NBOX.php,0,0,0,0,0
https://web.archive.org/web/20120123181817/http://www.iboum.com/pr/iomegd.php,0,0,0,0,0
https://web.archive.org/web/20141223030902/http://www.iboum.com/pr/ASUSO-AIR.php,0,0,0,0,0
https://web.archive.org/web/20120123111405/http://www.iboum.com/pr/ibox400.php,0,0,0,0,0
https://web.archive.org/web/20120123182240/http://www.iboum.com/pr/evo311.php,0,0,0,0,0
https://web.archive.org/web/20120127042900/http://www.iboum.com/pr/bolse.php,0,0,0,0,0
https://web.archive.org/web/20120123013820/http://www.iboum.com/pr/verbmdvr.php,0,0,0,0,0
https://web.archive.org/web/20120120085955/http://www.iboum.com/pr/icy311.php,0,0,0,0,0
https://web.archive.org/web/20141223044206/http://www.iboum.com/pr/gen8092.php,0,0,0,0,0
https://web.archive.org/web/20120127042900/http://www.iboum.com/pr/egreatr2a.php,0,0,0,0,0
https://web.archive.org/web/20120126230015/http://www.iboum.com/pr/nixfs.php,0,0,0,0,0
https://web.archive.org/web/20120123012520/http://www.iboum.com/pr/him900c.php,0,0,0,0,0
https://web.archive.org/web/20120123181147/http://www.iboum.com/pr/bev805.php,0,0,0,0,0
https://web.archive.org/web/20150703201701/http://www.iboum.com/pr/fantmini.php,0,0,0,0,0
https://web.archive.org/web/20150703201701/http://www.iboum.com/pr/ac-playon-dvr.php,0,0,0,0,0
https://web.archive.org/web/20120126115903/http://www.iboum.com/pr/egs800.php,0,0,0,0,0
https://web.archive.org/web/20120126115903/http://www.iboum.com/pr/egr6a2.php,0,0,0,0,0
https://web.archive.org/web/20120126164012/http://www.iboum.com/pr/egr12.php,0,0,0,0,0
https://web.archive.org/web/20150703201701/http://www.iboum.com/pr/dx320.php,0,0,0,0,0
https://web.archive.org/web/20120121224531/http://www.iboum.com/pr/stormytv.php,0,0,0,0,0
https://web.archive.org/web/20150703201701/http://www.iboum.com/pr/idera8.php,0,0,0,0,0
https://web.archive.org/web/20150703201701/http://www.iboum.com/pr/him600a.php,0,0,0,0,0
https://web.archive.org/web/20120126164012/http://www.iboum.com/pr/LARUG.php,0,0,0,0,0
https://web.archive.org/web/20150703201701/http://www.iboum.com/pr/leaguer1.php,0,0,0,0,0
https://web.archive.org/web/20120127054046/http://www.iboum.com/pr/d-pebble.php,0,0,0,0,0
https://web.archive.org/web/20120121224531/http://www.iboum.com/pr/olevia530.php,0,0,0,0,0
https://web.archive.org/web/20141223030834/http://www.iboum.com/pr/xtsid4.php,0,0,0,0,0
https://web.archive.org/web/20120123015255/http://www.iboum.com/pr/bolse.php,0,0,0,0,0
https://web.archive.org/web/20120123030208/http://www.iboum.com/pr/xtultra.php,0,0,0,0,0
https://web.archive.org/web/20120126115903/http://www.iboum.com/pr/eagetx5.php,0,0,0,0,0
https://web.archive.org/web/20120126115903/http://www.iboum.com/pr/goto5100.php,0,0,0,0,0
https://web.archive.org/web/20120123030208/http://www.iboum.com/pr/tvix6500.php,0,0,0,0,0
https://web.archive.org/web/20120126113939/http://www.iboum.com/pr/ioboxee.php,0,0,0,0,0
https://web.archive.org/web/20120123030208/http://www.iboum.com/pr/m2tvd.php,0,0,0,0,0
https://web.archive.org/web/20120126115903/http://www.iboum.com/pr/giec120.php,0,0,0,0,0
https://web.archive.org/web/20150703201701/http://www.iboum.com/pr/eaget850.php,0,0,0,0,0
https://web.archive.org/web/20120123015255/http://www.iboum.com/pr/miccamhd.php,0,0,0,0,0
https://web.archive.org/web/20120127054046/http://www.iboum.com/pr/qnap1000.php,0,0,0,0,0
https://web.archive.org/web/20120123015255/http://www.iboum.com/pr/verbmpro.php,0,0,0,0,0
https://web.archive.org/web/20120123030208/http://www.iboum.com/pr/howh3.php,0,0,0,0,0
https://web.archive.org/web/20120127054046/http://www.iboum.com/pr/netgear-neo-550.php,0,0,0,0,0
https://web.archive.org/web/20120126115903/http://www.iboum.com/pr/em7180.php,0,0,0,0,0
https://web.archive.org/web/20120126113939/http://www.iboum.com/pr/kaim1073.php,0,0,0,0,0
https://web.archive.org/web/20120126115903/http://www.iboum.com/pr/patbcore.php,0,0,0,0,0
https://web.archive.org/web/20120127054046/http://www.iboum.com/pr/inphi10.php,0,0,0,0,0
https://web.archive.org/web/20120126113939/http://www.iboum.com/pr/him900b.php,0,0,0,0,0
https://web.archive.org/web/20150703201701/http://www.iboum.com/pr/bluec7.php,0,0,0,0,0
https://web.archive.org/web/20120127054046/http://www.iboum.com/pr/egr900.php,0,0,0,0,0
https://web.archive.org/web/20120126113939/http://www.iboum.com/pr/xtsid3.php,0,0,0,0,0
https://web.archive.org/web/20120126113939/http://www.iboum.com/pr/datageHD.php,0,0,0,0,0
https://web.archive.org/web/20140819194655/http://www.iboum.com:80/pr/gen8092.php,0,0,0,0,0
https://web.archive.org/web/20150703201701/http://www.iboum.com/pr/eaget8802.php,0,0,0,0,0
https://web.archive.org/web/20120126115903/http://www.iboum.com/pr/egr6b.php,0,0,0,0,0
https://web.archive.org/web/20141223030834/http://www.iboum.com/pr/ems120h.php,0,0,0,0,0
https://web.archive.org/web/20120126164012/http://www.iboum.com/pr/asusmini.php,0,0,0,0,0
https://web.archive.org/web/20120126115903/http://www.iboum.com/pr/uebo400.php,0,0,0,0,0
https://web.archive.org/web/20141223030834/http://www.iboum.com/pr/measb4s.php,0,0,0,0,0
https://web.archive.org/web/20120127054046/http://www.iboum.com/pr/astone200.php,0,0,0,0,0
https://web.archive.org/web/20120126164012/http://www.iboum.com/pr/novad57.php,0,0,0,0,0
https://web.archive.org/web/20141223030834/http://www.iboum.com/pr/melea200.php,0,0,0,0,0
https://web.archive.org/web/20150703201701/http://www.iboum.com/pr/eboda500p.php,0,0,0,0,0
https://web.archive.org/web/20141223030834/http://www.iboum.com/pr/mygica582.php,0,0,0,0,0
https://web.archive.org/web/20120126164012/http://www.iboum.com/pr/eaget900.php,0,0,0,0,0
https://web.archive.org/web/20120123015255/http://www.iboum.com/pr/kai580.php,0,0,0,0,0
https://web.archive.org/web/20120126115903/http://www.iboum.com/pr/prodigi100.php,0,0,0,0,0
https://web.archive.org/web/20150703201701/http://www.iboum.com/pr/giec160.php,0,0,0,0,0
https://web.archive.org/web/20120126115903/http://www.iboum.com/pr/emk220.php,0,0,0,0,0
https://web.archive.org/web/20120121224531/http://www.iboum.com/pr/egreatr3a.php,0,0,0,0,0
https://web.archive.org/web/20120127054046/http://www.iboum.com/pr/egr150.php,0,0,0,0,0
https://web.archive.org/web/20120127054046/http://www.iboum.com/pr/bevix8078.php,0,0,0,0,0
https://web.archive.org/web/20120126164012/http://www.iboum.com/pr/med300.php,0,0,0,0,0
https://web.archive.org/web/20150703201701/http://www.iboum.com/pr/tvrb1mini.php,0,0,0,0,0
https://web.archive.org/web/20120126164012/http://www.iboum.com/pr/ac-playon-dvr.php,0,0,0,0,0
https://web.archive.org/web/20150703201701/http://www.iboum.com/pr/ent2000.php,0,0,0,0,0
https://web.archive.org/web/20120126164012/http://www.iboum.com/pr/kai750.php,0,0,0,0,0
https://web.archive.org/web/20120127054046/http://www.iboum.com/pr/miccmplay.php,0,0,0,0,0
https://web.archive.org/web/20120123030208/http://www.iboum.com/pr/PHA200.php,0,0,0,0,0
https://web.archive.org/web/20150703201701/http://www.iboum.com/pr/elek700.php,0,0,0,0,0
https://web.archive.org/web/20120126164012/http://www.iboum.com/pr/egreatr4a.php,0,0,0,0,0
https://web.archive.org/web/20150703201701/http://www.iboum.com/pr/icon52.php,0,0,0,0,0
https://web.archive.org/web/20120126115903/http://www.iboum.com/pr/seagoflex.php,0,0,0,0,0
https://web.archive.org/web/20120123015255/http://www.iboum.com/pr/emk220.php,0,0,0,0,0
https://web.archive.org/web/20120126115903/http://www.iboum.com/pr/qnap1000p.php,0,0,0,0,0
https://web.archive.org/web/20120123015255/http://www.iboum.com/pr/howv2.php,0,0,0,0,0
https://web.archive.org/web/20150703201701/http://www.iboum.com/pr/iconx100.php,0,0,0,0,0
https://web.archive.org/web/20141223030834/http://www.iboum.com/pr/fan3600.php,0,0,0,0,0
https://web.archive.org/web/20150703201701/http://www.iboum.com/pr/amfiretv.php,0,0,0,0,0
https://web.archive.org/web/20120126164012/http://www.iboum.com/pr/view74.php,0,0,0,0,0
https://web.archive.org/web/20120123030208/http://www.iboum.com/pr/acerrview.php,0,0,0,0,0
https://web.archive.org/web/20120126115903/http://www.iboum.com/pr/musicb200.php,0,0,0,0,0
https://web.archive.org/web/20120126164012/http://www.iboum.com/links.php,0,0,0,0,0
https://web.archive.org/web/20120127054046/http://www.iboum.com/pr/eagetm90.php,0,0,0,0,0
https://web.archive.org/web/20141223030834/http://www.iboum.com/pr/egr300.php,0,0,0,0,0
https://web.archive.org/web/20120126113939/http://www.iboum.com/pr/myga3n.php,0,0,0,0,0
https://web.archive.org/web/20150703201701/http://www.iboum.com/pr/PH100.php,0,0,0,0,0
https://web.archive.org/web/20120121224531/http://www.iboum.com/pr/ph5000.php,0,0,0,0,0
https://web.archive.org/web/20141223030834/http://www.iboum.com/pr/tvixs1.php,0,0,0,0,0
https://web.archive.org/web/20120127054046/http://www.iboum.com/pr/tizzf20.php,0,0,0,0,0
https://web.archive.org/web/20120127054046/http://www.iboum.com/pr/novad82.php,0,0,0,0,0
https://web.archive.org/web/20141223030834/http://www.iboum.com/pr/icontmantra.php,0,0,0,0,0
https://web.archive.org/web/20111111072908/http://www.iboum.com/pr/novad82.php,0,0,0,0,0
https://web.archive.org/web/20141223030834/http://www.iboum.com/pr/pha410.php,0,0,0,0,0
https://web.archive.org/web/20120126115903/http://www.iboum.com/pr/PH200.php,0,0,0,0,0
https://web.archive.org/web/20120126164012/http://www.iboum.com/pr/ibewan.php,0,0,0,0,0
https://web.archive.org/web/20120123015255/http://www.iboum.com/pr/fanttv.php,0,0,0,0,0
https://web.archive.org/web/20141223030834/http://www.iboum.com/pr/pop35.php,0,0,0,0,0
https://web.archive.org/web/20141223030834/http://www.iboum.com/pr/ggsony1.php,0,0,0,0,0
https://web.archive.org/web/20120123015255*/http://www.iboum.com/pr/verbmdvr.php,0,0,0,0,0
https://web.archive.org/web/20141223030834/http://www.iboum.com/pr/droidmx2.php,0,0,0,0,0
https://web.archive.org/web/20150703201701/http://www.iboum.com/pr/ugs82.php,0,0,0,0,0
https://web.archive.org/web/20120123030208/http://www.iboum.com/pr/egreats2.php,0,0,0,0,0
https://web.archive.org/web/20120127054046/http://www.iboum.com/pr/em7297.php,0,0,0,0,0
https://web.archive.org/web/20141223030834/http://www.iboum.com/pr/egr2002.php,0,0,0,0,0
https://web.archive.org/web/20120123015255/http://www.iboum.com/pr/midt1080.php,0,0,0,0,0
https://web.archive.org/web/20120126164012/http://www.iboum.com/pr/micep600.php,0,0,0,0,0
https://web.archive.org/web/20120121224531/http://www.iboum.com/pr/freexs.php,0,0,0,0,0
https://web.archive.org/web/20120126115903/http://www.iboum.com/pr/hdx2000.php,0,0,0,0,0
https://web.archive.org/web/20120126164012/http://www.iboum.com/pr/kai750li.php,0,0,0,0,0
https://web.archive.org/web/20120126164012/http://www.iboum.com/pr/em7280.php,0,0,0,0,0
https://web.archive.org/web/20120123015255/http://www.iboum.com/pr/novad57.php,0,0,0,0,0
https://web.archive.org/web/20120123015255/http://www.iboum.com/pr/hornetshow.php,0,0,0,0,0
https://web.archive.org/web/20120123030208/http://www.iboum.com/pr/him560b.php,0,0,0,0,0
https://web.archive.org/web/20150703201701/http://www.iboum.com/pr/eagetm6.php,0,0,0,0,0
https://web.archive.org/web/20120127054046/http://www.iboum.com/pr/fanttv.php,0,0,0,0,0
https://web.archive.org/web/20120123015255/http://www.iboum.com/pr/inphi9.php,0,0,0,0,0
https://web.archive.org/web/20120126113939/http://www.iboum.com/pr/emtec800.php,0,0,0,0,0
https://web.archive.org/web/20120126164012/http://www.iboum.com/pr/egreats1a.php,0,0,0,0,0
https://web.archive.org/web/20120127054046/http://www.iboum.com/pr/mede8er.php,0,0,0,0,0
https://web.archive.org/web/20120123015255/http://www.iboum.com/pr/dune101.php,0,0,0,0,0
https://web.archive.org/web/20141223030834/http://www.iboum.com/pr/riko8023s.php,0,0,0,0,0
https://web.archive.org/web/20120123015255/http://www.iboum.com/pr/howu3.php,0,0,0,0,0
https://web.archive.org/web/20120126164012/http://www.iboum.com/pr/diyoxs.php,0,0,0,0,0
https://web.archive.org/web/20120127054046/http://www.iboum.com/pr/mediagate.php,0,0,0,0,0
https://web.archive.org/web/20120123015255/http://www.iboum.com/links.php,0,0,0,0,0
https://web.archive.org/web/20150703201701/http://www.iboum.com/pr/giec230.php,0,0,0,0,0
https://web.archive.org/web/20120123030208/http://www.iboum.com/pr/blue3550.php,0,0,0,0,0
https://web.archive.org/web/20120126113939/http://www.iboum.com/pr/10m581.php,0,0,0,0,0
https://web.archive.org/web/20120126113939/http://www.iboum.com/pr/em7095.php,0,0,0,0,0
https://web.archive.org/web/20120126113939/http://www.iboum.com/pr/acplayhdm.php,0,0,0,0,0
https://web.archive.org/web/20120126113939/http://www.iboum.com/pr/emtecs800.php,0,0,0,0,0
https://web.archive.org/web/20120126164012/http://www.iboum.com/pr/gmins120.php,0,0,0,0,0
https://web.archive.org/web/20120126113939/http://www.iboum.com/pr/ferg200a.php,0,0,0,0,0
https://web.archive.org/web/20120126164012/http://www.iboum.com/pr/aigop6a.php,0,0,0,0,0
https://web.archive.org/web/20120126113939/http://www.iboum.com/pr/gmins1100.php,0,0,0,0,0
https://web.archive.org/web/20120126164012/http://www.iboum.com/pr/nad446.php,0,0,0,0,0
https://web.archive.org/web/20120123030208/http://www.iboum.com/pr/yangh2.php,0,0,0,0,0
https://web.archive.org/web/20120127054046/http://www.iboum.com/pr/myga3n.php,0,0,0,0,0
https://web.archive.org/web/20120126113939/http://www.iboum.com/pr/wdtvmini.php,0,0,0,0,0
https://web.archive.org/web/20120126113939/http://www.iboum.com/pr/lg-dp1w.php,0,0,0,0,0
https://web.archive.org/web/20150703201701/http://www.iboum.com/pr/astone100.php,0,0,0,0,0
https://web.archive.org/web/20120126164012/http://www.iboum.com/pr/ng9150.php,0,0,0,0,0
https://web.archive.org/web/20141223030834/http://www.iboum.com/pr/howu5.php,0,0,0,0,0
https://web.archive.org/web/20141223030834/http://www.iboum.com/pr/minixx7.php,0,0,0,0,0
https://web.archive.org/web/20120126115903/http://www.iboum.com/pr/med200.php,0,0,0,0,0
https://web.archive.org/web/20120126115903/http://www.iboum.com/pr/pha300.php,0,0,0,0,0
https://web.archive.org/web/20120126115903/http://www.iboum.com/pr/FREEAG.php,0,0,0,0,0
https://web.archive.org/web/20120123015255/http://www.iboum.com/pr/mvult.php,0,0,0,0,0
https://web.archive.org/web/20141223030834/http://www.iboum.com/pr/realh3.php,0,0,0,0,0
https://web.archive.org/web/20120123030208/http://www.iboum.com/pr/10m550.php,0,0,0,0,0
https://web.archive.org/web/20150703201701/http://www.iboum.com/pr/dune203.php,0,0,0,0,0
https://web.archive.org/web/20120121224531/http://www.iboum.com/pr/howh5.php,0,0,0,0,0
https://web.archive.org/web/20150703201701/http://www.iboum.com/pr/fan3ds.php,0,0,0,0,0
https://web.archive.org/web/20150703201701/http://www.iboum.com/pr/pico51.php,0,0,0,0,0
https://web.archive.org/web/20150703201701/http://www.iboum.com/pr/icy316.php,0,0,0,0,0
https://web.archive.org/web/20120126164012/http://www.iboum.com/pr/em7095.php,0,0,0,0,0
https://web.archive.org/web/20120123015255/http://www.iboum.com/pr/hornetfan.php,0,0,0,0,0
https://web.archive.org/web/20120126115903/http://www.iboum.com/pr/him900b.php,0,0,0,0,0
https://web.archive.org/web/20120123030208/http://www.iboum.com/pr/astone100.php,0,0,0,0,0
https://web.archive.org/web/20141223030834/http://www.iboum.com/pr/gen8092.php,0,0,0,0,0
https://web.archive.org/web/20150703201701/http://www.iboum.com/pr/lacla.php,0,0,0,0,0
https://web.archive.org/web/20120121224531/http://www.iboum.com/pr/tvix3600.php,0,0,0,0,0
https://web.archive.org/web/20120123015255/http://www.iboum.com/pr/em7297.php,0,0,0,0,0
https://web.archive.org/web/20120126113939/http://www.iboum.com/pr/evoblade.php,0,0,0,0,0
https://web.archive.org/web/20150703201701/http://www.iboum.com/pr/view70.php,0,0,0,0,0
https://web.archive.org/web/20150703201701/http://www.iboum.com/pr/darkmm.php,0,0,0,0,0
https://web.archive.org/web/20120126164012/http://www.iboum.com/pr/dune101.php,0,0,0,0,0
https://web.archive.org/web/20120126164012/http://www.iboum.com/pr/hdx-bd1.php,0,0,0,0,0
https://web.archive.org/web/20120123015255/http://www.iboum.com/pr/datprod.php,0,0,0,0,0
https://web.archive.org/web/20120121224531/http://www.iboum.com/pr/pha210.php,0,0,0,0,0
https://web.archive.org/web/20141223030834/http://www.iboum.com/pr/stormytv.php,0,0,0,0,0
https://web.archive.org/web/20120127054046/http://www.iboum.com/pr/med200.php,0,0,0,0,0
https://web.archive.org/web/20141223030834/http://www.iboum.com/pr/kwsp1200.php,0,0,0,0,0
https://web.archive.org/web/20150703201701/http://www.iboum.com/pr/mapstv1.php,0,0,0,0,0
https://web.archive.org/web/20120121224531/http://www.iboum.com/pr/ider201.php,0,0,0,0,0
https://web.archive.org/web/20141223030834/http://www.iboum.com/pr/yuxx.php,0,0,0,0,0
https://web.archive.org/web/20150703201701/http://www.iboum.com/pr/WDTV2-LIVE.php,0,0,0,0,0
https://web.archive.org/web/20141223030834/http://www.iboum.com/pr/fan2700.php,0,0,0,0,0
https://web.archive.org/web/20120126164012/http://www.iboum.com/pr/blue2543.php,0,0,0,0,0
https://web.archive.org/web/20120123015255/http://www.iboum.com/pr/XTREAMER.php,0,0,0,0,0
https://web.archive.org/web/20120123030208/http://www.iboum.com/pr/bright5005.php,0,0,0,0,0
https://web.archive.org/web/20120127054046/http://www.iboum.com/pr/wdtvlive11.php,0,0,0,0,0
https://web.archive.org/web/20120123015255/http://www.iboum.com/pr/brplay.php,0,0,0,0,0
https://web.archive.org/web/20120126164012/http://www.iboum.com/artkill/media-player-glossary.php,0,0,0,0,0
https://web.archive.org/web/20120126164012/http://www.iboum.com/pr/xentamkv.php,0,0,0,0,0
https://web.archive.org/web/20120127054046/http://www.iboum.com/pr/kai360i.php,0,0,0,0,0
https://web.archive.org/web/20141223030834/http://www.iboum.com/pr/measyu4k.php,0,0,0,0,0
https://web.archive.org/web/20120123030208/http://www.iboum.com/net-media-players.php,0,0,0,0,0
https://web.archive.org/web/20120126113939/http://www.iboum.com/pr/astone110.php,0,0,0,0,0
https://web.archive.org/web/20120123030208/http://www.iboum.com/pr/hisense800.php,0,0,0,0,0
https://web.archive.org/web/20120126115903/http://www.iboum.com/pr/lg-dp1w.php,0,0,0,0,0
https://web.archive.org/web/20120126164012/http://www.iboum.com/pr/astone200.php,0,0,0,0,0
https://web.archive.org/web/20120126115903/http://www.iboum.com/pr/brplay.php,0,0,0,0,0
https://web.archive.org/web/20120127054046/http://www.iboum.com/pr/ast310dt.php,0,0,0,0,0
https://web.archive.org/web/20120123030208/http://www.iboum.com/pr/mygv5.php,0,0,0,0,0
https://web.archive.org/web/20141223030834/http://www.iboum.com/pr/mykam.php,0,0,0,0,0
https://web.archive.org/web/20120126115903/http://www.iboum.com/pr/med85015.php,0,0,0,0,0
https://web.archive.org/web/20141223030834/http://www.iboum.com/pr/laclahd.php,0,0,0,0,0
https://web.archive.org/web/20120123030208/http://www.iboum.com/pr/terr520.php,0,0,0,0,0
https://web.archive.org/web/20120123015255/http://www.iboum.com/artkill/media-player-glossary.php,0,0,0,0,0
https://web.archive.org/web/20150703201701/http://www.iboum.com/pr/ugoo802.php,0,0,0,0,0
https://web.archive.org/web/20120126115903/http://www.iboum.com/pr/ariva210.php,0,0,0,0,0
https://web.archive.org/web/20141223030834/http://www.iboum.com/pr/jynxboxm.php,0,0,0,0,0
https://web.archive.org/web/20120127054046/http://www.iboum.com/pr/hornetshow.php,0,0,0,0,0
https://web.archive.org/web/20150703201701/http://www.iboum.com/pr/minixx8p.php,0,0,0,0,0
https://web.archive.org/web/20150703201701/http://www.iboum.com/pr/tvixn1.php,0,0,0,0,0
https://web.archive.org/web/20150703201701/http://www.iboum.com/pr/meleg02.php,0,0,0,0,0
https://web.archive.org/web/20120127054046/http://www.iboum.com/pr/egr6a2.php,0,0,0,0,0
https://web.archive.org/web/20120126115903/http://www.iboum.com/pr/roku1.php,0,0,0,0,0
https://web.archive.org/web/20120123030208/http://www.iboum.com/pr/fanxhd7.php,0,0,0,0,0
https://web.archive.org/web/20120121224531/http://www.iboum.com/pr/bolse.php,0,0,0,0,0
https://web.archive.org/web/20120126164012/http://www.iboum.com/pr/sumcycmicro.php,0,0,0,0,0
https://web.archive.org/web/20120121224531/http://www.iboum.com/pr/pivaios.php,0,0,0,0,0
https://web.archive.org/web/20120121224531/http://www.iboum.com/pr/mvult.php,0,0,0,0,0
https://web.archive.org/web/20120126113939/http://www.iboum.com/pr/med300.php,0,0,0,0,0
https://web.archive.org/web/20120121224531/http://www.iboum.com/pr/avercin.php,0,0,0,0,0
https://web.archive.org/web/20141223030834/http://www.iboum.com/pr/cloudcr16.php,0,0,0,0,0
https://web.archive.org/web/20120123030208/http://www.iboum.com/pr/tizzf30.php,0,0,0,0,0
https://web.archive.org/web/20150703201701/http://www.iboum.com/pr/acerrview.php,0,0,0,0,0
https://web.archive.org/web/20150703201701/http://www.iboum.com/pr/xenta3d.php,0,0,0,0,0
https://web.archive.org/web/20120123015255/http://www.iboum.com/pr/yatay100.php,0,0,0,0,0
https://web.archive.org/web/20120126113939/http://www.iboum.com/pr/egr180.php,0,0,0,0,0
https://web.archive.org/web/20120121224531/http://www.iboum.com/pr/egr100.php,0,0,0,0,0
https://web.archive.org/web/20120126115903/http://www.iboum.com/pr/kai580.php,0,0,0,0,0
https://web.archive.org/web/20141223030834/http://www.iboum.com/pr/dune-smart-d1.php,0,0,0,0,0
https://web.archive.org/web/20120123015255/http://www.iboum.com/pr/aigop6a.php,0,0,0,0,0
https://web.archive.org/web/20141223030834/http://www.iboum.com/pr/hdx-bone.php,0,0,0,0,0
https://web.archive.org/web/20120126115903/http://www.iboum.com/pr/em7297.php,0,0,0,0,0
https://web.archive.org/web/20150703201701/http://www.iboum.com/pr/roku2xs.php,0,0,0,0,0
https://web.archive.org/web/20120123030208/http://www.iboum.com/pr/eboda500p.php,0,0,0,0,0
https://web.archive.org/web/20120123030208/http://www.iboum.com/pr/novad29.php,0,0,0,0,0
https://web.archive.org/web/20120123030208/http://www.iboum.com/pr/sumcycpr.php,0,0,0,0,0
https://web.archive.org/web/20120123030208/http://www.statcounter.com/wordpress.org/,0,0,0,0,0
https://web.archive.org/web/20120121224531/http://www.iboum.com/pr/howu3.php,0,0,0,0,0
https://web.archive.org/web/20120126113939/http://www.iboum.com/pr/hdium1.php,0,0,0,0,0
https://web.archive.org/web/20141223030834/http://www.iboum.com/pr/uga80.php,0,0,0,0,0
https://web.archive.org/web/20120121224531/http://www.iboum.com/artkill/hd-audio-media-players.php,0,0,0,0,0
https://web.archive.org/web/20150703201701/http://www.iboum.com/pr/giec300.php,0,0,0,0,0
https://web.archive.org/web/20141223030834/http://www.iboum.com/RSS/rssfeed.rss,0
https://web.archive.org/web/20120126115903/http://www.iboum.com/pr/playon-plus.php,0,0,0,0,0
https://web.archive.org/web/20120123030208/http://www.iboum.com/pr/ferg310.php,0,0,0,0,0
https://web.archive.org/web/20120123015255/http://www.iboum.com/pr/pha300.php,0,0,0,0,0
https://web.archive.org/web/20120126115903/http://www.iboum.com/pr/howh3.php,0,0,0,0,0
https://web.archive.org/web/20120126115903/http://www.iboum.com/pr/egr150.php,0,0,0,0,0
https://web.archive.org/web/20150703201701/http://www.iboum.com/pr/emk220h.php,0,0,0,0,0
https://web.archive.org/web/20120126115903/http://www.futeko.com/navpage/media-players.php,0,0,0,0,0
https://web.archive.org/web/20120123015255/http://www.iboum.com/pr/egs800.php,0,0,0,0,0
https://web.archive.org/web/20120126113939/http://www.iboum.com/pr/iomegplus.php,0,0,0,0,0
https://web.archive.org/web/20120123015255/http://www.iboum.com/pr/kogitv.php,0,0,0,0,0
https://web.archive.org/web/20120126115903/http://www.iboum.com/pr/novad58.php,0,0,0,0,0
https://web.archive.org/web/20120123015255/http://www.iboum.com/pr/hdx-bd1.php,0,0,0,0,0
https://web.archive.org/web/20120126164012/http://www.iboum.com/pr/mediagate.php,0,0,0,0,0
https://web.archive.org/web/20120126115903/http://www.iboum.com/pr/myga3n.php,0,0,0,0,0
https://web.archive.org/web/20120126113939/http://www.iboum.com/pr/xtelv.php,0,0,0,0,0
https://web.archive.org/web/20120123015255/http://www.iboum.com/pr/wdtvlive11.php,0,0,0,0,0
https://web.archive.org/web/20120126113939/http://www.iboum.com/pr/bolmob.php,0,0,0,0,0
https://web.archive.org/web/20150703201701/http://www.iboum.com/pr/ega1.php,0,0,0,0,0
https://web.archive.org/web/20120126164012/http://www.iboum.com/pr/datprod.php,0,0,0,0,0
https://web.archive.org/web/20120127054046/http://www.iboum.com/pr/toshstv.php,0,0,0,0,0
https://web.archive.org/web/20150703201701/http://www.iboum.com/pr/measyu2a.php,0,0,0,0,0
https://web.archive.org/web/20120123030208/http://www.iboum.com/pr/rokuxds.php,0,0,0,0,0
https://web.archive.org/web/20120127054046/http://www.iboum.com/pr/egreats2.php,0,0,0,0,0
https://web.archive.org/web/20120127054046/http://www.iboum.com/pr/bolmob.php,0,0,0,0,0
https://web.archive.org/web/20120126113939/http://www.iboum.com/pr/kai1055p.php,0,0,0,0,0
https://web.archive.org/web/20141223030834/http://www.iboum.com/pr/geniatv200.php,0,0,0,0,0
https://web.archive.org/web/20120127054046/http://www.iboum.com/pr/kaih1073.php,0,0,0,0,0
https://web.archive.org/web/20120126113939/http://www.iboum.com/pr/wdtv-elephant-play.php,0,0,0,0,0
https://web.archive.org/web/20120126113939/http://www.iboum.com/pr/XTREAMER.php,0,0,0,0,0
https://web.archive.org/web/20120126115903/http://www.iboum.com/pr/acplayhdp.php,0,0,0,0,0
https://web.archive.org/web/20120121224531/http://www.iboum.com/pr/arg335.php,0,0,0,0,0
https://web.archive.org/web/20120126113939/http://www.iboum.com/pr/kaif6000b.php,0,0,0,0,0
https://web.archive.org/web/20141223030834/http://www.iboum.com/pr/pipox6.php,0,0,0,0,0
https://web.archive.org/web/20141223030834/http://www.futeko.com/navpage/miracast-chipset-comparison.php,0,0,0,0,0
https://web.archive.org/web/20150703201701/http://www.iboum.com/pr/himh1.php,0,0,0,0,0
https://web.archive.org/web/20120126113939/http://www.iboum.com/pr/ph3000.php,0,0,0,0,0
https://web.archive.org/web/20120126115903/http://www.iboum.com/pr/summic2.php,0,0,0,0,0
https://web.archive.org/web/20120123015255/http://www.iboum.com/pr/em7180.php,0,0,0,0,0
https://web.archive.org/web/20150703201701/http://www.iboum.com/pr/egreata1080.php,0,0,0,0,0
https://web.archive.org/web/20120123030208/http://www.iboum.com/pr/kai860i.php,0,0,0,0,0
https://web.archive.org/web/20120123015255/http://www.iboum.com/pr/FREEAG.php,0,0,0,0,0
https://web.archive.org/web/20120126164012/http://www.iboum.com/pr/laminihd.php,0,0,0,0,0
https://web.archive.org/web/20141223030834/http://www.iboum.com/pr/melem01.php,0,0,0,0,0
https://web.archive.org/web/20120123015255/http://www.iboum.com/pr/evoblade.php,0,0,0,0,0
https://web.archive.org/web/20120121224531/http://www.iboum.com/pr/ASUSO-AIR.php,0,0,0,0,0
https://web.archive.org/web/20141223030834/http://www.iboum.com/pr/auvis1.php,0,0,0,0,0
https://web.archive.org/web/20150703201701/http://www.iboum.com/pr/riko902.php,0,0,0,0,0
https://web.archive.org/web/20120126164012/http://www.iboum.com/pr/leagues1.php,0,0,0,0,0
https://web.archive.org/web/20150703201701/http://www.iboum.com/pr/pipox1.php,0,0,0,0,0
https://web.archive.org/web/20120121224531/http://www.iboum.com/pr/hdx2000.php,0,0,0,0,0
https://web.archive.org/web/20141223030834/http://www.iboum.com/pr/kodakt1.php,0,0,0,0,0
https://web.archive.org/web/20120126115903/http://www.iboum.com/pr/inphi9.php,0,0,0,0,0
https://web.archive.org/web/20120123030208/http://www.iboum.com/pr/xtprod.php,0,0,0,0,0
https://web.archive.org/web/20120126115903/http://www.iboum.com/pr/tvix3600.php,0,0,0,0,0
https://web.archive.org/web/20141223030834/http://www.iboum.com/pr/minixnx5p.php,0,0,0,0,0
https://web.archive.org/web/20141223030834/http://www.iboum.com/pr/ekenstv.php,0,0,0,0,0
https://web.archive.org/web/20120126113939/http://www.iboum.com/pr/envivoa.php,0,0,0,0,0
https://web.archive.org/web/20120126113939/http://www.iboum.com/pr/egr150.php,0,0,0,0,0
https://web.archive.org/web/20150703201701/http://www.iboum.com/pr/icon7l.php,0,0,0,0,0
https://web.archive.org/web/20120123030208/http://www.iboum.com/pr/datm1.php,0,0,0,0,0
https://web.archive.org/web/20120121224531/http://www.iboum.com/pr/net2000live.php,0,0,0,0,0
https://web.archive.org/web/20120126113939/http://www.iboum.com/pr/ideri6fh.php,0,0,0,0,0
https://web.archive.org/web/20150703201701/http://www.iboum.com/pr/sage300.php,0,0,0,0,0
https://web.archive.org/web/20120126113939/http://www.iboum.com/pr/WDTV-MK2.php,0,0,0,0,0
https://web.archive.org/web/20141223030834/http://www.iboum.com/pr/asushd2.php,0,0,0,0,0
https://web.archive.org/web/20120127054046/http://www.iboum.com/pr/4gplayo.php,0,0,0,0,0
https://web.archive.org/web/20150703201701/http://www.iboum.com/pr/med4x2.php,0,0,0,0,0
https://web.archive.org/web/20120126164012/http://www.iboum.com/pr/iomegtvd.php,0,0,0,0,0
https://web.archive.org/web/20120126164012/http://www.iboum.com/pr/him900a.php,0,0,0,0,0
https://web.archive.org/web/20120123015255/http://www.iboum.com/pr/myga3n.php,0,0,0,0,0
https://web.archive.org/web/20141223030834/http://www.iboum.com/pr/minixnx3.php,0,0,0,0,0
https://web.archive.org/web/20120123015255/http://www.iboum.com/pr/gmin890.php,0,0,0,0,0
https://web.archive.org/web/20150703201701/http://www.iboum.com/pr/sumlive.php,0,0,0,0,0
https://web.archive.org/web/20141223030834/http://www.iboum.com/pr/dune301.php,0,0,0,0,0
https://web.archive.org/web/20120127054046/http://www.iboum.com/pr/inphi9.php,0,0,0,0,0
https://web.archive.org/web/20120123030208/http://www.iboum.com/pr/ast310dt.php,0,0,0,0,0
https://web.archive.org/web/20141223030834/http://www.iboum.com/pr/noona6powerp.php,0,0,0,0,0
https://web.archive.org/web/20120126115903/http://www.iboum.com/pr/howv3.php,0,0,0,0,0
https://web.archive.org/web/20120127054046/http://www.iboum.com/pr/egr180.php,0,0,0,0,0
https://web.archive.org/web/20120123030208/http://www.iboum.com/pr/lgxf2.php,0,0,0,0,0
https://web.archive.org/web/20120121224531/http://www.iboum.com/pr/eagetx5.php,0,0,0,0,0
https://web.archive.org/web/20120126115903/http://www.iboum.com/pr/sumcycpr.php,0,0,0,0,0
https://web.archive.org/web/20120126113939/http://www.iboum.com/pr/ng9150.php,0,0,0,0,0
https://web.archive.org/web/20120126113939/http://www.iboum.com/pr/fanttv.php,0,0,0,0,0
https://web.archive.org/web/20120126113939/http://www.iboum.com/pr/view74.php,0,0,0,0,0
https://web.archive.org/web/20120126113939/http://www.iboum.com/pr/ellion500.php,0,0,0,0,0
https://web.archive.org/web/20120123030208/http://www.iboum.com/pr/kaih1073.php,0,0,0,0,0
https://web.archive.org/web/20141223030834/http://www.iboum.com/pr/hi500b.php,0,0,0,0,0
https://web.archive.org/web/20120126113939/http://www.iboum.com/pr/egr6a2.php,0,0,0,0,0
https://web.archive.org/web/20120126164012/http://www.iboum.com/pr/kai355i.php,0,0,0,0,0
https://web.archive.org/web/20120126115903/http://www.iboum.com/pr/ASUSO.php,0,0,0,0,0
https://web.archive.org/web/20120123030208/http://www.iboum.com/pr/noonv12.php,0,0,0,0,0
https://web.archive.org/web/20120121224531/http://www.iboum.com/pr/icy312.php,0,0,0,0,0
https://web.archive.org/web/20120126164012/http://www.iboum.com/pr/evo311.php,0,0,0,0,0
https://web.archive.org/web/20120121224531/http://www.iboum.com/pr/med400.php,0,0,0,0,0
https://web.archive.org/web/20120127054046/http://www.iboum.com/pr/em7280.php,0,0,0,0,0
https://web.archive.org/web/20120127054046/http://www.iboum.com/pr/kogitv.php,0,0,0,0,0
https://web.archive.org/web/20120126115903/http://www.iboum.com/pr/ol3hd.php,0,0,0,0,0
https://web.archive.org/web/20120123015255/http://www.iboum.com/pr/fan2750.php,0,0,0,0,0
https://web.archive.org/web/20120123015255/http://www.iboum.com/pr/ideri9.php,0,0,0,0,0
https://web.archive.org/web/20120123015255/http://www.iboum.com/pr/noona6p.php,0,0,0,0,0
https://web.archive.org/web/20150703201701/http://www.iboum.com/pr/minixx8s.php,0,0,0,0,0
https://web.archive.org/web/20120121224531/http://www.iboum.com/pr/yanghdpro+.php,0,0,0,0,0
https://web.archive.org/web/20120126115903/http://www.iboum.com/pr/10m581.php,0,0,0,0,0
https://web.archive.org/web/20141223030834/http://www.iboum.com/pr/tpmini.php,0,0,0,0,0
https://web.archive.org/web/20120126113939/http://www.iboum.com/pr/med45x2.php,0,0,0,0,0
https://web.archive.org/web/20120126113939/http://www.iboum.com/pr/novad58.php,0,0,0,0,0
https://web.archive.org/web/20120121224531/http://www.iboum.com/pr/him200a.php,0,0,0,0,0
https://web.archive.org/web/20120126113939/http://www.iboum.com/pr/emk220.php,0,0,0,0,0
https://web.archive.org/web/20120123030208/http://www.iboum.com/pr/med85015.php,0,0,0,0,0
https://web.archive.org/web/20120126113939/http://www.iboum.com/pr/toshstvp.php,0,0,0,0,0
https://web.archive.org/web/20120127054046/http://www.iboum.com/pr/dxd1.php,0,0,0,0,0
https://web.archive.org/web/20120121224531/http://www.iboum.com/pr/asia1.php,0,0,0,0,0
https://web.archive.org/web/20120126164012/http://www.iboum.com/pr/tvix7000.php,0,0,0,0,0
https://web.archive.org/web/20120123015255/http://www.iboum.com/pr/em200.php,0,0,0,0,0
https://web.archive.org/web/20120126115903/http://www.iboum.com/artkill/media-player-on-demand-content.php,0,0,0,0,0
https://web.archive.org/web/20120123030208/http://www.iboum.com/pr/measyx7.php,0,0,0,0,0
https://web.archive.org/web/20120126113939/http://www.iboum.com/pr/cirago1000.php,0,0,0,0,0
https://web.archive.org/web/20120123015255/http://www.iboum.com/pr/emtec800.php,0,0,0,0,0
https://web.archive.org/web/20120121224531/http://www.iboum.com/pr/micc250.php,0,0,0,0,0
https://web.archive.org/web/20141223030834/http://www.iboum.com/pr/pivxiosm3.php,0,0,0,0,0
https://web.archive.org/web/20120126164012/http://www.iboum.com/pr/ibox400.php,0,0,0,0,0
https://web.archive.org/web/20120123030208/http://www.iboum.com/pr/xtreamsid2.php,0,0,0,0,0
https://web.archive.org/web/20150703201701/http://www.iboum.com/pr/horntek-phantom.php,0,0,0,0,0
https://web.archive.org/web/20120126115903/http://www.iboum.com/pr/egreats2.php,0,0,0,0,0
https://web.archive.org/web/20141223030834/http://www.iboum.com/pr/acplayhdp.php,0,0,0,0,0
https://web.archive.org/web/20150703201701/http://www.iboum.com/pr/egr500.php,0,0,0,0,0
https://web.archive.org/web/20150703201701/http://www.iboum.com/pr/pipox1mk2.php,0,0,0,0,0
https://web.archive.org/web/20120126113939/http://www.iboum.com/pr/wdtvlive11.php,0,0,0,0,0
https://web.archive.org/web/20120121224531/http://www.iboum.com/pr/storslim.php,0,0,0,0,0
https://web.archive.org/web/20141223030834/http://www.iboum.com/pr/riko902ii.php,0,0,0,0,0
https://web.archive.org/web/20141223030834/http://www.iboum.com/pr/acveolo.php,0,0,0,0,0
https://web.archive.org/web/20120127054046/http://www.iboum.com/pr/em7095.php,0,0,0,0,0
https://web.archive.org/web/20120123030208/http://www.iboum.com/pr/tvixn1.php,0,0,0,0,0
https://web.archive.org/web/20120121224531/http://www.iboum.com/pr/egr200.php,0,0,0,0,0
https://web.archive.org/web/20120126115903/http://www.iboum.com/bloog/,0,0,0,0,0
https://web.archive.org/web/20120121224531/http://www.iboum.com/pr/ferg110.php,0,0,0,0,0
https://web.archive.org/web/20120121224531/http://www.iboum.com/pr/ariva210.php,0,0,0,0,0
https://web.archive.org/web/20120123015255/http://www.iboum.com/pr/eagetm9.php,0,0,0,0,0
https://web.archive.org/web/20141223030834/http://www.iboum.com/pr/egr160.php,0,0,0,0,0
https://web.archive.org/web/20120123030208/mailto:mail@iboum.com,0,0,0,0,0
https://web.archive.org/web/20120126113939/http://www.iboum.com/pr/avercin.php,0,0,0,0,0
https://web.archive.org/web/20141223030834/http://www.iboum.com/pr/noona6p.php,0,0,0,0,0
https://web.archive.org/web/20120123030208/http://www.iboum.com/pr/HDX1000.php,0,0,0,0,0
https://web.archive.org/web/20120123030208/http://www.iboum.com/pr/sage200.php,0,0,0,0,0
https://web.archive.org/web/20150703201701/http://www.iboum.com/pr/view73.php,0,0,0,0,0
https://web.archive.org/web/20120126164012/http://www.statcounter.com/wordpress.org/,0,0,0,0,0
https://web.archive.org/web/20120126113939/http://www.iboum.com/pr/ferg110.php,0,0,0,0,0
https://web.archive.org/web/20150703201701/http://www.iboum.com/pr/reko8093.php,0,0,0,0,0
https://web.archive.org/web/20120127054046/http://www.iboum.com/pr/fanalup.php,0,0,0,0,0
https://web.archive.org/web/20141223030834/http://www.iboum.com/pr/sarot6b.php,0,0,0,0,0
https://web.archive.org/web/20141223030834/http://www.iboum.com/pr/musicb200.php,0,0,0,0,0
https://web.archive.org/web/20150703201701/http://www.iboum.com/pr/datastor.php,0,0,0,0,0
https://web.archive.org/web/20120127054046/http://www.iboum.com/pr/xtprod2.php,0,0,0,0,0
https://web.archive.org/web/20120123015255/http://www.iboum.com/pr/meas8hd.php,0,0,0,0,0
https://web.archive.org/web/20150703201701/http://www.iboum.com/pr/gen8091.php,0,0,0,0,0
https://web.archive.org/web/20120121224531/http://www.iboum.com/pr/em8100.php,0,0,0,0,0
https://web.archive.org/web/20141223030834/http://www.iboum.com/pr/sumslim2.php,0,0,0,0,0
https://web.archive.org/web/20150703201701/http://www.iboum.com/pr/ol3hd.php,0,0,0,0,0
https://web.archive.org/web/20120123030208/http://www.iboum.com/pr/sumlive.php,0,0,0,0,0
https://web.archive.org/web/20120126164012/http://www.iboum.com/pr/howv2.php,0,0,0,0,0
https://web.archive.org/web/20120126164012/http://www.iboum.com/pr/lgsmart.php,0,0,0,0,0
https://web.archive.org/web/20120121224531/http://www.iboum.com/pr/evo311.php,0,0,0,0,0
https://web.archive.org/web/20120123030208/http://www.iboum.com/pr/kai320.php,0,0,0,0,0
https://web.archive.org/web/20150703201701/http://www.iboum.com/pr/xentamini.php,0,0,0,0,0
https://web.archive.org/web/20150703201701/http://www.iboum.com/pr/jesa19.php,0,0,0,0,0
https://web.archive.org/web/20120121224531/http://www.futeko.com/navpage/media-players.php,0,0,0,0,0
https://web.archive.org/web/20120123015255/http://www.iboum.com/pr/myka-ion.php,0,0,0,0,0
https://web.archive.org/web/20120126115903/http://www.iboum.com/pr/m2tvd.php,0,0,0,0,0
https://web.archive.org/web/20120127054046/http://www.iboum.com/pr/melev6.php,0,0,0,0,0
https://web.archive.org/web/20120121224531/http://www.iboum.com/pr/egs100.php,0,0,0,0,0
https://web.archive.org/web/20120123030208/http://www.iboum.com/pr/nboxv3.php,0,0,0,0,0
https://web.archive.org/web/20120126113939/http://www.iboum.com/pr/summic2.php,0,0,0,0,0
https://web.archive.org/web/20120126113939/http://www.iboum.com/pr/yatay100.php,0,0,0,0,0
https://web.archive.org/web/20150703201701/http://www.iboum.com/pr/poppst30.php,0,0,0,0,0
https://web.archive.org/web/20120121224531/http://www.iboum.com/RSS/rssfeed.rss,0
https://web.archive.org/web/20120121224531/http://www.iboum.com/pr/novad58.php,0,0,0,0,0
https://web.archive.org/web/20120126115903/http://www.iboum.com/pr/datm1.php,0,0,0,0,0
https://web.archive.org/web/20150703201701/http://www.iboum.com/pr/ASUSO.php,0,0,0,0,0
https://web.archive.org/web/20120123015255/http://www.iboum.com/pr/netg8000.php,0,0,0,0,0
https://web.archive.org/web/20120123030208/http://www.iboum.com/pr/view70.php,0,0,0,0,0
https://web.archive.org/web/20120126113939/http://www.iboum.com/pr/egreatr4b.php,0,0,0,0,0
https://web.archive.org/web/20120123015255/http://www.iboum.com/pr/dathdx2.php,0,0,0,0,0
https://web.archive.org/web/20120127054046/http://www.scripts.oldguy.us/,0,0,0,0,0
https://web.archive.org/web/20120126115903/http://www.iboum.com/pr/ioboxee.php,0,0,0,0,0
https://web.archive.org/web/20120127054046/http://www.iboum.com/pr/uebo200.php,0,0,0,0,0
https://web.archive.org/web/20120126113939/http://www.iboum.com/pr/eagetx5.php,0,0,0,0,0
https://web.archive.org/web/20120123015255/http://www.iboum.com/pr/kaim1073.php,0,0,0,0,0
https://web.archive.org/web/20141223030834/http://www.iboum.com/pr/micca950.php,0,0,0,0,0
https://web.archive.org/web/20120123015255/http://www.iboum.com/pr/poppst30.php,0,0,0,0,0
https://web.archive.org/web/20120126113939/http://www.iboum.com/pr/kai580.php,0,0,0,0,0
https://web.archive.org/web/20120123030208/http://www.iboum.com/pr/fan2300.php,0,0,0,0,0
https://web.archive.org/web/20120127054046/http://www.iboum.com/pr/him600b.php,0,0,0,0,0
https://web.archive.org/web/20150703201701/http://www.iboum.com/pr/ovalscam.php,0,0,0,0,0
https://web.archive.org/web/20120126113939/http://www.iboum.com/pr/fantech-fhdl.php,0,0,0,0,0
https://web.archive.org/web/20141223030834/http://www.iboum.com/pr/meas8hd.php,0,0,0,0,0
https://web.archive.org/web/20120127054046/http://www.iboum.com/pr/mykam.php,0,0,0,0,0
https://web.archive.org/web/20141223030834/http://www.iboum.com/pr/pnip5.php,0,0,0,0,0
https://web.archive.org/web/20141223030834/http://www.iboum.com/pr/genj22d.php,0,0,0,0,0
https://web.archive.org/web/20150703201701/http://www.iboum.com/pr/riko8022.php,0,0,0,0,0
https://web.archive.org/web/20141223030834/http://www.iboum.com/pr/view75.php,0,0,0,0,0
https://web.archive.org/web/20120126115903/http://www.iboum.com/pr/ol4hd.php,0,0,0,0,0
https://web.archive.org/web/20120126113939/http://www.iboum.com/pr/egreatr2a.php,0,0,0,0,0
https://web.archive.org/web/20150703201701/http://www.iboum.com/pr/measyx7.php,0,0,0,0,0
https://web.archive.org/web/20120121224531/http://www.iboum.com/pr/emtecv120.php,0,0,0,0,0
https://web.archive.org/web/20120127054046/http://www.iboum.com/pr/summic2p.php,0,0,0,0,0
https://web.archive.org/web/20120126164012/http://www.iboum.com/pr/10m581.php,0,0,0,0,0
https://web.archive.org/web/20120126164012/http://www.iboum.com/pr/mediavx.php,0,0,0,0,0
https://web.archive.org/web/20120123015255/http://www.iboum.com/pr/xentamini.php,0,0,0,0,0
https://web.archive.org/web/20120126164012/http://www.iboum.com/pr/roku2lt.php,0,0,0,0,0
https://web.archive.org/web/20120126141638/http://www.iboum.com/pr/playon-mini-plus.php,0,0,0,0,0
https://web.archive.org/web/20141223032154/http://www.iboum.com/pr/verbmpro.php,0,0,0,0,0
https://web.archive.org/web/20120126134836/http://www.iboum.com/pr/icy316.php,0,0,0,0,0
https://web.archive.org/web/20120121132158/http://www.iboum.com/bloog/,0,0,0,0,0
https://web.archive.org/web/20120123053849/http://www.iboum.com/pr/ider201.php,0,0,0,0,0
https://web.archive.org/web/20120127023840/http://www.iboum.com/pr/icy305.php,0,0,0,0,0
https://web.archive.org/web/20150703201707/http://www.iboum.com/pr/noonv9.php,0,0,0,0,0
https://web.archive.org/web/20141223032154/http://www.iboum.com/pr/bright5005.php,0,0,0,0,0
https://web.archive.org/web/20150703193601/http://www.iboum.com/pr/uebo200.php,0,0,0,0,0
https://web.archive.org/web/20120123053849/http://www.iboum.com/pr/egr6a2.php,0,0,0,0,0
https://web.archive.org/web/20120127010956/http://www.iboum.com/pr/mygv5.php,0,0,0,0,0
https://web.archive.org/web/20150703195001/http://www.iboum.com/pr/diyoxs.php,0,0,0,0,0
https://web.archive.org/web/20150703195139/http://www.iboum.com/pr/jesq8.php,0,0,0,0,0
https://web.archive.org/web/20120127010956/http://www.iboum.com/pr/him800b.php,0,0,0,0,0
https://web.archive.org/web/20150703201216/http://www.iboum.com/pr/egreatr2a.php,0,0,0,0,0
https://web.archive.org/web/20120126164102/http://www.iboum.com/pr/eaget8802.php,0,0,0,0,0
https://web.archive.org/web/20120127044121/http://www.iboum.com/pr/popboxv8.php,0,0,0,0,0
https://web.archive.org/web/20150703201232/http://www.iboum.com/pr/arg335.php,0,0,0,0,0
https://web.archive.org/web/20120127035943/http://www.iboum.com/pr/kaim1073.php,0,0,0,0,0
https://web.archive.org/web/20120127060402/http://www.iboum.com/pr/icon4sl.php,0,0,0,0,0
https://web.archive.org/web/20120127012616/http://www.iboum.com/pr/lg-dp1w.php,0,0,0,0,0
https://web.archive.org/web/20150703203715/http://www.iboum.com/pr/himh8.php,0,0,0,0,0
https://web.archive.org/web/20120126131329/http://www.iboum.com/pr/sony200.php,0,0,0,0,0
https://web.archive.org/web/20150703201232/http://www.iboum.com/pr/eageth5.php,0,0,0,0,0
https://web.archive.org/web/20120127035943/http://www.iboum.com/pr/inphi9.php,0,0,0,0,0
https://web.archive.org/web/20120127025254/http://www.iboum.com/pr/ac-playon-dvr.php,0,0,0,0,0
https://web.archive.org/web/20120127060402/http://www.iboum.com/pr/iomegplus.php,0,0,0,0,0
https://web.archive.org/web/20150703201232/http://www.iboum.com/pr/egreatr4b.php,0,0,0,0,0
https://web.archive.org/web/20150703193408/http://www.iboum.com/pr/fansmdisk.php,0,0,0,0,0
https://web.archive.org/web/20150703204305/http://www.iboum.com/pr/pha300.php,0,0,0,0,0
https://web.archive.org/web/20120127012616/http://www.iboum.com/pr/dopodo2000.php,0,0,0,0,0
https://web.archive.org/web/20150703203443/http://www.iboum.com/pr/ider201.php,0,0,0,0,0
https://web.archive.org/web/20150703201232/http://www.iboum.com/pr/midt1080.php,0,0,0,0,0
https://web.archive.org/web/20120127060402/http://www.iboum.com/pr/10m581.php,0,0,0,0,0
https://web.archive.org/web/20150703204729/http://www.iboum.com/pr/jesmxu6d.php,0,0,0,0,0
https://web.archive.org/web/20150703193408/http://www.iboum.com/pr/medianow101.php,0,0,0,0,0
https://web.archive.org/web/20120127044529/http://www.iboum.com/pr/acplayhdp.php,0,0,0,0,0
https://web.archive.org/web/20120127012616/http://www.iboum.com/pr/mykam.php,0,0,0,0,0
https://web.archive.org/web/20150703193408/http://www.iboum.com/pr/egr300.php,0,0,0,0,0
https://web.archive.org/web/20120127035943/http://www.iboum.com/pr/brplay.php,0,0,0,0,0
https://web.archive.org/web/20141223030744/http://www.iboum.com/pr/emtecv120.php,0,0,0,0,0
https://web.archive.org/web/20150703193408/http://www.iboum.com/pr/fan3d.php,0,0,0,0,0
https://web.archive.org/web/20141223030744/http://www.iboum.com/pr/pivxiosm3.php,0,0,0,0,0
https://web.archive.org/web/20141223030744/http://www.iboum.com/pr/jess82.php,0,0,0,0,0
https://web.archive.org/web/20150703201232/http://www.iboum.com/pr/novad29.php,0,0,0,0,0
https://web.archive.org/web/20150703204305/http://www.iboum.com/pr/droidmx2.php,0,0,0,0,0
https://web.archive.org/web/20120127025254/http://www.iboum.com/pr/d-pebble.php,0,0,0,0,0
https://web.archive.org/web/20150703204305/http://www.iboum.com/pr/kogitv.php,0,0,0,0,0
https://web.archive.org/web/20141223030744/http://www.iboum.com/pr/tvroid.php,0,0,0,0,0
https://web.archive.org/web/20120127025254/http://www.iboum.com/pr/eagetm9.php,0,0,0,0,0
https://web.archive.org/web/20150703193408/http://www.iboum.com/pr/pha410.php,0,0,0,0,0
https://web.archive.org/web/20150703193408/http://www.iboum.com/pr/terr520.php,0,0,0,0,0
https://web.archive.org/web/20120127025254/http://www.iboum.com/pr/roku2lt.php,0,0,0,0,0
https://web.archive.org/web/20150703204305/http://www.iboum.com/pr/himq5.php,0,0,0,0,0
https://web.archive.org/web/20141223030744/http://www.iboum.com/pr/riko902ii.php,0,0,0,0,0
https://web.archive.org/web/20141223030744/http://www.iboum.com/pr/egr200s.php,0,0,0,0,0
https://web.archive.org/web/20120127035943/http://www.iboum.com/pr/rokuxd.php,0,0,0,0,0
https://web.archive.org/web/20150703203715/http://www.iboum.com/pr/jes868.php,0,0,0,0,0
https://web.archive.org/web/20150703203715/http://www.iboum.com/pr/sunw8.php,0,0,0,0,0
https://web.archive.org/web/20150703204305/http://www.iboum.com/pr/FREEAG.php,0,0,0,0,0
https://web.archive.org/web/20150703204305/http://www.iboum.com/pr/kaiw110.php,0,0,0,0,0
https://web.archive.org/web/20120127060402/http://www.iboum.com/pr/gmins1100.php,0,0,0,0,0
https://web.archive.org/web/20150703203715/http://www.iboum.com/pr/micca350g2.php,0,0,0,0,0
https://web.archive.org/web/20150703203443/http://www.iboum.com/pr/kai550.php,0,0,0,0,0
https://web.archive.org/web/20120126131329/http://www.iboum.com/pr/dune-smart-d1.php,0,0,0,0,0
https://web.archive.org/web/20120126212918/http://www.iboum.com/pr/hi500b.php,0,0,0,0,0
https://web.archive.org/web/20150703193408/http://www.iboum.com/pr/droidmx2.php,0,0,0,0,0
https://web.archive.org/web/20120127044529/http://www.iboum.com/pr/sonyn100.php,0,0,0,0,0
https://web.archive.org/web/20150703203443/http://www.iboum.com/pr/jynxbox.php,0,0,0,0,0
https://web.archive.org/web/20120126131329/http://www.iboum.com/pr/howh5.php,0,0,0,0,0
https://web.archive.org/web/20150703203715/http://www.iboum.com/pr/med85015.php,0,0,0,0,0
https://web.archive.org/web/20150703204305/http://www.iboum.com/pr/popcham.php,0,0,0,0,0
https://web.archive.org/web/20120127035943/http://www.iboum.com/pr/kogitv.php,0,0,0,0,0
https://web.archive.org/web/20120127044529/http://www.iboum.com/pr/emin.php,0,0,0,0,0
https://web.archive.org/web/20150703204729/http://www.iboum.com/pr/melea2000.php,0,0,0,0,0
https://web.archive.org/web/20141223030744/http://www.iboum.com/pr/bev805.php,0,0,0,0,0
https://web.archive.org/web/20141223030744/http://www.iboum.com/pr/met22.php,0,0,0,0,0
https://web.archive.org/web/20120127060402/http://www.iboum.com/pr/acfluxx.php,0,0,0,0,0
https://web.archive.org/web/20120127012616/http://www.iboum.com/pr/envivoa.php,0,0,0,0,0
https://web.archive.org/web/20120127044529/http://www.iboum.com/pr/sumcycmicro.php,0,0,0,0,0
https://web.archive.org/web/20150703201232/http://www.iboum.com/pr/gboxmx3.php,0,0,0,0,0
https://web.archive.org/web/20120127025254/http://www.iboum.com/pr/gmin890.php,0,0,0,0,0
https://web.archive.org/web/20150703203443/http://www.iboum.com/pr/med45x2.php,0,0,0,0,0
https://web.archive.org/web/20150703204305/http://www.iboum.com/pr/him910b.php,0,0,0,0,0
https://web.archive.org/web/20120127044529/http://www.iboum.com/pr/PHA200.php,0,0,0,0,0
https://web.archive.org/web/20150703193546/http://www.iboum.com/pr/fan3700.php,0,0,0,0,0
https://web.archive.org/web/20141223051802/http://www.iboum.com/pr/easy4mini.php,0,0,0,0,0
https://web.archive.org/web/20150703204102/http://www.iboum.com/pr/zotac320.php,0,0,0,0,0
https://web.archive.org/web/20120127053249/http://www.iboum.com/pr/patbcore.php,0,0,0,0,0
https://web.archive.org/web/20150703203234/http://www.iboum.com/pr/iomegspd.php,0,0,0,0,0
https://web.archive.org/web/20150703201201/http://www.iboum.com/pr/kwm200.php,0,0,0,0,0
https://web.archive.org/web/20150703203007/http://www.iboum.com/pr/measb4s.php,0,0,0,0,0
https://web.archive.org/web/20150703203911/http://www.iboum.com/pr/google-tv.php,0,0,0,0,0
https://web.archive.org/web/20141223044201/http://www.iboum.com/pr/riko80.php,0,0,0,0,0
https://web.archive.org/web/20150703203200/http://www.iboum.com/pr/kai860i.php,0,0,0,0,0
https://web.archive.org/web/20150703203911/http://www.iboum.com/pr/terr520.php,0,0,0,0,0
https://web.archive.org/web/20120127053249/http://www.iboum.com/pr/icon52.php,0,0,0,0,0
https://web.archive.org/web/20120127055015/http://www.iboum.com/pr/mygv8.php,0,0,0,0,0
https://web.archive.org/web/20150703184318/http://www.iboum.com/pr/genand1.php,0,0,0,0,0
https://web.archive.org/web/20141223044201/http://www.iboum.com/pr/minix6.php,0,0,0,0,0
https://web.archive.org/web/20150703203911/http://www.iboum.com/pr/arcstv.php,0,0,0,0,0
https://web.archive.org/web/20150703203234/http://www.iboum.com/pr/idera8.php,0,0,0,0,0
https://web.archive.org/web/20150703185317/http://www.iboum.com/pr/egreatr3a.php,0,0,0,0,0
https://web.archive.org/web/20141223052713/http://www.iboum.com/pr/yatay100.php,0,0,0,0,0
https://web.archive.org/web/20150703194133/http://www.iboum.com/pr/gnexusq.php,0,0,0,0,0
https://web.archive.org/web/20150703194133/http://www.iboum.com/pr/noonv12.php,0,0,0,0,0
https://web.archive.org/web/20150708021204/http://www.iboum.com/pr/howu3.php,0,0,0,0,0
https://web.archive.org/web/20150703194133/http://www.iboum.com/pr/woxa100.php,0,0,0,0,0
https://web.archive.org/web/20150703193506/http://www.iboum.com/pr/eagetm9.php,0,0,0,0,0
https://web.archive.org/web/20120126231612/http://www.iboum.com/pr/tvixs1.php,0,0,0,0,0
https://web.archive.org/web/20120126225353/http://www.iboum.com/pr/bevix6030.php,0,0,0,0,0
https://web.archive.org/web/20150703210602/http://www.iboum.com/pr/howu3.php,0,0,0,0,0
https://web.archive.org/web/20141223051802/http://www.iboum.com/pr/popcham.php,0,0,0,0,0
https://web.archive.org/web/20150703194111/http://www.iboum.com/pr/amfiretv.php,0,0,0,0,0
https://web.archive.org/web/20141223051720/http://www.iboum.com/pr/eagetx5.php,0,0,0,0,0
https://web.archive.org/web/20150703193909/http://www.iboum.com/pr/egreats1a.php,0,0,0,0,0
https://web.archive.org/web/20150703195238/http://www.iboum.com/pr/ferg110.php,0,0,0,0,0
https://web.archive.org/web/20120126231612/http://www.iboum.com/pr/laminihd.php,0,0,0,0,0
https://web.archive.org/web/20150703191429/http://www.iboum.com/pr/zotac320.php,0,0,0,0,0
https://web.archive.org/web/20120127032718/http://www.iboum.com/pr/pico51.php,0,0,0,0,0
https://web.archive.org/web/20120127030354/http://www.iboum.com/pr/bevix6010.php,0,0,0,0,0
https://web.archive.org/web/20150703194036/http://www.iboum.com/pr/him800b.php,0,0,0,0,0
https://web.archive.org/web/20150524052811/http://www.iboum.com/pr/woxa200.php,0,0,0,0,0
https://web.archive.org/web/20150708021204/http://www.iboum.com/pr/compro1000.php,0,0,0,0,0
https://web.archive.org/web/20150703203200/http://www.iboum.com/pr/egreata1080.php,0,0,0,0,0
https://web.archive.org/web/20150703203234/http://www.iboum.com/pr/j1nxtlbb.php,0,0,0,0,0
https://web.archive.org/web/20150703203623/http://www.iboum.com/pr/rekoqt800.php,0,0,0,0,0
https://web.archive.org/web/20150703184318/http://www.iboum.com/pr/sumslim2.php,0,0,0,0,0
https://web.archive.org/web/20150703210602/http://www.iboum.com/pr/verbmdvr.php,0,0,0,0,0
https://web.archive.org/web/20150703194133/http://www.iboum.com/pr/measyu1a.php,0,0,0,0,0
https://web.archive.org/web/20150703194036/http://www.iboum.com/pr/roku2xd.php,0,0,0,0,0
https://web.archive.org/web/20150703203623/http://www.iboum.com/pr/dxdroid.php,0,0,0,0,0
https://web.archive.org/web/20150703184318/http://www.iboum.com/pr/himm34k.php,0,0,0,0,0
https://web.archive.org/web/20141223052713/http://www.iboum.com/pr/sumx2e.php,0,0,0,0,0
https://web.archive.org/web/20120126231721/http://www.iboum.com/pr/gmin890.php,0,0,0,0,0
https://web.archive.org/web/20120126133124/http://www.iboum.com/pr/em7180.php,0,0,0,0,0
https://web.archive.org/web/20120127053249/http://www.iboum.com/pr/toshstv.php,0,0,0,0,0
https://web.archive.org/web/20150703204102/http://www.iboum.com/pr/horntek-phantom.php,0,0,0,0,0
https://web.archive.org/web/20150703194036/http://www.iboum.com/pr/himh1.php,0,0,0,0,0
https://web.archive.org/web/20150703210555/http://www.iboum.com/pr/datproi5.php,0,0,0,0,0
https://web.archive.org/web/20150703201201/http://www.iboum.com/pr/geniatv1200.php,0,0,0,0,0
https://web.archive.org/web/20120126133124/http://www.iboum.com/pr/netg8000.php,0,0,0,0,0
https://web.archive.org/web/20150111024709/http://www.iboum.com/pr/med13d.php,0,0,0,0,0
https://web.archive.org/web/20150703204102/http://www.iboum.com/pr/howu3.php,0,0,0,0,0
https://web.archive.org/web/20150703203623/http://www.iboum.com/pr/imation.php,0,0,0,0,0
https://web.archive.org/web/20150703194111/http://www.iboum.com/pr/vidbox.php,0,0,0,0,0
https://web.archive.org/web/20150703193909/http://www.iboum.com/pr/myga3.php,0,0,0,0,0
https://web.archive.org/web/20150703203204/http://www.iboum.com/pr/xiaomimi.php,0,0,0,0,0
https://web.archive.org/web/20120127030354/http://www.iboum.com/pr/bolmob.php,0,0,0,0,0
https://web.archive.org/web/20150703203204/http://www.iboum.com/pr/kai860i.php,0,0,0,0,0
https://web.archive.org/web/20150703185317/http://www.iboum.com/pr/yatay100.php,0,0,0,0,0
https://web.archive.org/web/20150524052811/http://www.iboum.com/pr/minixnx4.php,0,0,0,0,0
https://web.archive.org/web/20150703195159/http://www.iboum.com/pr/novad58.php,0,0,0,0,0
https://web.archive.org/web/20141223052713/http://www.iboum.com/pr/XTREAMER.php,0,0,0,0,0
https://web.archive.org/web/20150524052811/http://www.iboum.com/pr/sumx2.php,0,0,0,0,0
https://web.archive.org/web/20150703203200/http://www.iboum.com/pr/pivxiosm3.php,0,0,0,0,0
https://web.archive.org/web/20150708021204/http://www.iboum.com/pr/him600b.php,0,0,0,0,0
https://web.archive.org/web/20150703184318/http://www.iboum.com/pr/lacla.php,0,0,0,0,0
https://web.archive.org/web/20150703203007/http://www.iboum.com/pr/geniatv200.php,0,0,0,0,0
https://web.archive.org/web/20150524052811/http://www.iboum.com/pr/kai210.php,0,0,0,0,0
https://web.archive.org/web/20120127030354/http://www.iboum.com/pr/netg8000.php,0,0,0,0,0
https://web.archive.org/web/20150524045041/http://www.iboum.com/pr/jes8093.php,0,0,0,0,0
https://web.archive.org/web/20150703204102/http://www.iboum.com/pr/netgear-neo-550.php,0,0,0,0,0
https://web.archive.org/web/20141223051802/http://www.iboum.com/pr/ol4hd.php,0,0,0,0,0
https://web.archive.org/web/20120127055015/http://www.iboum.com/pr/kai860i.php,0,0,0,0,0
https://web.archive.org/web/20150703193506/http://www.iboum.com/pr/egr500.php,0,0,0,0,0
https://web.archive.org/web/20150524052811/http://www.iboum.com/pr/ronmp40.php,0,0,0,0,0
https://web.archive.org/web/20141223052713/http://www.iboum.com/pr/jynxm1v2.php,0,0,0,0,0
https://web.archive.org/web/20150703203234/http://www.iboum.com/pr/bluec7.php,0,0,0,0,0
https://web.archive.org/web/20141223051802/http://www.iboum.com/pr/med13d.php,0,0,0,0,0
https://web.archive.org/web/20150703194042/http://www.iboum.com/pr/med5x2.php,0,0,0,0,0
https://web.archive.org/web/20150703194111/http://www.iboum.com/pr/ol3hd.php,0,0,0,0,0
https://web.archive.org/web/20120126133124/http://www.iboum.com/pr/uebo200.php,0,0,0,0,0
https://web.archive.org/web/20150524045100/http://www.iboum.com/pr/summic2p.php,0,0,0,0,0
https://web.archive.org/web/20150524045100/http://www.iboum.com/pr/hornetshow.php,0,0,0,0,0
https://web.archive.org/web/20141223051720/http://www.iboum.com/pr/conc-cm3hd.php,0,0,0,0,0
https://web.archive.org/web/20150703203200/http://www.iboum.com/pr/melev6.php,0,0,0,0,0
https://web.archive.org/web/20150703193909/http://www.iboum.com/pr/noona6p.php,0,0,0,0,0
https://web.archive.org/web/20120127053249/http://www.iboum.com/pr/goto5100.php,0,0,0,0,0
https://web.archive.org/web/20150703203007/http://www.iboum.com/pr/egr2002.php,0,0,0,0,0
https://web.archive.org/web/20141223052713/http://www.iboum.com/pr/mediavx.php,0,0,0,0,0
https://web.archive.org/web/20150703203200/http://www.iboum.com/pr/riko902ii.php,0,0,0,0,0
https://web.archive.org/web/20141223052713/http://www.iboum.com/pr/em200.php,0,0,0,0,0
https://web.archive.org/web/20120126133124/http://www.iboum.com/pr/fanttv.php,0,0,0,0,0
https://web.archive.org/web/20150703193606/http://www.iboum.com/pr/idera8.php,0,0,0,0,0
https://web.archive.org/web/20150703193511/http://www.iboum.com/pr/evoblade.php,0,0,0,0,0
https://web.archive.org/web/20150703194036/http://www.iboum.com/pr/eaget900.php,0,0,0,0,0
https://web.archive.org/web/20150703185317/http://www.iboum.com/pr/XTREAMER.php,0,0,0,0,0
https://web.archive.org/web/20120126133124/http://www.iboum.com/pr/xentamini.php,0,0,0,0,0
https://web.archive.org/web/20150703194111/http://www.iboum.com/pr/net2000live.php,0,0,0,0,0
https://web.archive.org/web/20141223052713/http://www.iboum.com/pr/genem6.php,0,0,0,0,0
https://web.archive.org/web/20120127013104/http://www.iboum.com/pr/dat1055.php,0,0,0,0,0
https://web.archive.org/web/20141223052713/http://www.iboum.com/pr/giec260.php,0,0,0,0,0
https://web.archive.org/web/20120126133124/http://www.iboum.com/pr/med200.php,0,0,0,0,0
https://web.archive.org/web/20150524045041/http://www.iboum.com/pr/dune403.php,0,0,0,0,0
https://web.archive.org/web/20150703193511/http://www.iboum.com/pr/melev6.php,0,0,0,0,0
https://web.archive.org/web/20120127055015/http://www.iboum.com/pr/eyef10.php,0,0,0,0,0
https://web.archive.org/web/20150703204102/http://www.iboum.com/pr/hdx-bd1.php,0,0,0,0,0
https://web.archive.org/web/20150703185317/http://www.iboum.com/pr/olevia530.php,0,0,0,0,0
https://web.archive.org/web/20150703203200/http://www.iboum.com/pr/nationite-hdvp1.php,0,0,0,0,0
https://web.archive.org/web/20150703193606/http://www.iboum.com/pr/yanghdpro+.php,0,0,0,0,0
https://web.archive.org/web/20120126225353/http://www.iboum.com/pr/dathdx2.php,0,0,0,0,0
https://web.archive.org/web/20150703210602/http://www.iboum.com/pr/rikoa20m.php,0,0,0,0,0
https://web.archive.org/web/20150703204746/http://www.iboum.com/pr/fan2750.php,0,0,0,0,0
https://web.archive.org/web/20120127053249/http://www.iboum.com/pr/fanalup.php,0,0,0,0,0
https://web.archive.org/web/20141223051802/http://www.iboum.com/pr/m2tvd.php,0,0,0,0,0
https://web.archive.org/web/20150703185317/http://www.iboum.com/pr/uga80.php,0,0,0,0,0
https://web.archive.org/web/20150524052811/http://www.iboum.com/pr/ugoosut1.php,0,0,0,0,0
https://web.archive.org/web/20120126133124/http://www.iboum.com/pr/dune3.php,0,0,0,0,0
https://web.archive.org/web/20150703203200/http://www.iboum.com/pr/blueahdd3.php,0,0,0,0,0
https://web.archive.org/web/20150111024709/http://www.iboum.com/pr/sonyu10.php,0,0,0,0,0
https://web.archive.org/web/20150703193511/http://www.iboum.com/pr/kogitv.php,0,0,0,0,0
https://web.archive.org/web/20150703203623/http://www.iboum.com/pr/zaggbox.php,0,0,0,0,0
https://web.archive.org/web/20150703193423/http://www.iboum.com/pr/measyu1a.php,0,0,0,0,0
https://web.archive.org/web/20150703203007/http://www.iboum.com/pr/emk230.php,0,0,0,0,0
https://web.archive.org/web/20150703203234/http://www.iboum.com/pr/xentaav.php,0,0,0,0,0
https://web.archive.org/web/20141223051802/http://www.iboum.com/pr/genia310b.php,0,0,0,0,0
https://web.archive.org/web/20150703203204/http://www.iboum.com/pr/itab48r.php,0,0,0,0,0
https://web.archive.org/web/20141223051720/http://www.iboum.com/pr/egreatr2a.php,0,0,0,0,0
https://web.archive.org/web/20150703203204/http://www.iboum.com/pr/micc350.php,0,0,0,0,0
https://web.archive.org/web/20150703203911/http://www.iboum.com/pr/tvix3600.php,0,0,0,0,0
https://web.archive.org/web/20150703185317/http://www.iboum.com/pr/jynxm1v2.php,0,0,0,0,0
https://web.archive.org/web/20120127030354/http://www.iboum.com/pr/10m581.php,0,0,0,0,0
https://web.archive.org/web/20120127030354/http://www.iboum.com/pr/egr180.php,0,0,0,0,0
https://web.archive.org/web/20120127055015/http://www.iboum.com/pr/micc350.php,0,0,0,0,0
https://web.archive.org/web/20150703184318/http://www.iboum.com/pr/gen8093.php,0,0,0,0,0
https://web.archive.org/web/20150703191429/http://www.iboum.com/pr/datastor.php,0,0,0,0,0
https://web.archive.org/web/20150703194036/http://www.iboum.com/pr/playon-mini-plus.php,0,0,0,0,0
https://web.archive.org/web/20150703184318/http://www.iboum.com/pr/nixfs.php,0,0,0,0,0
https://web.archive.org/web/20120127055015/http://www.iboum.com/pr/asusmini.php,0,0,0,0,0
https://web.archive.org/web/20150703194133/http://www.iboum.com/pr/icy311.php,0,0,0,0,0
https://web.archive.org/web/20150524052811/http://www.iboum.com/pr/em7195.php,0,0,0,0,0
https://web.archive.org/web/20150703203007/http://www.iboum.com/pr/ems120h.php,0,0,0,0,0
https://web.archive.org/web/20150703184318/http://www.iboum.com/pr/fansmhub.php,0,0,0,0,0
https://web.archive.org/web/20141223051720/http://www.iboum.com/pr/hdium1.php,0,0,0,0,0
https://web.archive.org/web/20150703194133/http://www.iboum.com/pr/tvix6500.php,0,0,0,0,0
https://web.archive.org/web/20120126231612/http://www.iboum.com/pr/gmins120.php,0,0,0,0,0
https://web.archive.org/web/20150111024709/http://www.iboum.com/pr/mykam.php,0,0,0,0,0
https://web.archive.org/web/20150524052811/http://www.iboum.com/pr/verbmpro.php,0,0,0,0,0
https://web.archive.org/web/20150703195238/http://www.iboum.com/pr/qnap1000p.php,0,0,0,0,0
https://web.archive.org/web/20150703193423/http://www.iboum.com/pr/riko8024.php,0,0,0,0,0
https://web.archive.org/web/20120126225353/http://www.iboum.com/pr/fan2750.php,0,0,0,0,0
https://web.archive.org/web/20150524045100/http://www.iboum.com/pr/him300b.php,0,0,0,0,0
https://web.archive.org/web/20120127055015/http://www.iboum.com/pr/kw101.php,0,0,0,0,0
https://web.archive.org/web/20150703204102/http://www.iboum.com/pr/med13d.php,0,0,0,0,0
https://web.archive.org/web/20120127053249/http://www.iboum.com/pr/fan3ds.php,0,0,0,0,0
https://web.archive.org/web/20150703195238/http://www.iboum.com/pr/avercin.php,0,0,0,0,0
https://web.archive.org/web/20141223044201/http://www.iboum.com/pr/micca500.php,0,0,0,0,0
https://web.archive.org/web/20150703193546/http://www.iboum.com/pr/10m550.php,0,0,0,0,0
https://web.archive.org/web/20150703210555/http://www.iboum.com/pr/verbmdvr.php,0,0,0,0,0
https://web.archive.org/web/20160728195525/http://www.iboum.com:80/pr/terr520.php,0,0,0,0,0
https://web.archive.org/web/20141223052713/http://www.iboum.com/pr/zyxel250.php,0,0,0,0,0
https://web.archive.org/web/20150703194036/http://www.iboum.com/pr/med63d.php,0,0,0,0,0
https://web.archive.org/web/20150703193606/http://www.iboum.com/pr/eagetm7.php,0,0,0,0,0
https://web.archive.org/web/20150703203204/http://www.iboum.com/pr/icon52.php,0,0,0,0,0
https://web.archive.org/web/20150703203911/http://www.iboum.com/pr/easy4mini.php,0,0,0,0,0
https://web.archive.org/web/20150703193511/http://www.iboum.com/pr/miccslim.php,0,0,0,0,0
https://web.archive.org/web/20120127053249/http://www.iboum.com/pr/kai360i.php,0,0,0,0,0
https://web.archive.org/web/20150703201201/http://www.iboum.com/pr/egs100.php,0,0,0,0,0
https://web.archive.org/web/20150703191429/http://www.iboum.com/pr/noonv12.php,0,0,0,0,0
https://web.archive.org/web/20150703191530/http://www.iboum.com/pr/olevia530.php,0,0,0,0,0
https://web.archive.org/web/20141104191156/http://www.iboum.com/pr/egr160.php,0,0,0,0,0
https://web.archive.org/web/20150703191711/http://www.iboum.com/pr/tronv89.php,0,0,0,0,0
https://web.archive.org/web/20150703204431/http://www.iboum.com/pr/novad57.php,0,0,0,0,0
https://web.archive.org/web/20150703203250/http://www.iboum.com/pr/riko902ii.php,0,0,0,0,0
https://web.archive.org/web/20150703201656/http://www.iboum.com/pr/horntek-phantom.php,0,0,0,0,0
https://web.archive.org/web/20150703203721/http://www.iboum.com/pr/ASUSO-AIR.php,0,0,0,0,0
https://web.archive.org/web/20150703204724/http://www.iboum.com/pr/icy3010.php,0,0,0,0,0
https://web.archive.org/web/20150703202925/http://www.iboum.com/pr/gen8092.php,0,0,0,0,0
https://web.archive.org/web/20150703201636/http://www.iboum.com/pr/riko902ii.php,0,0,0,0,0
https://web.archive.org/web/20150703203845/http://www.iboum.com/pr/bluemx5.php,0,0,0,0,0
https://web.archive.org/web/20150703204612/http://www.iboum.com/pr/mele1000g.php,0,0,0,0,0
https://web.archive.org/web/20150629155027/http://www.iboum.com/pr/ovalscam.php,0,0,0,0,0
https://web.archive.org/web/20150703195253/http://www.iboum.com/pr/bright5005.php,0,0,0,0,0
https://web.archive.org/web/20150703204724/http://www.iboum.com/pr/exq2m.php,0,0,0,0,0
https://web.archive.org/web/20150703195205/http://www.iboum.com/pr/avextreme.php,0,0,0,0,0
https://web.archive.org/web/20150703191616/http://www.iboum.com/pr/measyu4a.php,0,0,0,0,0
https://web.archive.org/web/20141223051843/http://www.iboum.com/pr/compro1000.php,0,0,0,0,0
https://web.archive.org/web/20150703185015/http://www.iboum.com/pr/mygv8.php,0,0,0,0,0
https://web.archive.org/web/20150703195033/http://www.iboum.com/pr/egreatr4a.php,0,0,0,0,0
https://web.archive.org/web/20150602070359/http://www.iboum.com/pr/ugoosut2.php,0,0,0,0,0
https://web.archive.org/web/20150703204125/http://www.iboum.com/pr/melem9.php,0,0,0,0,0
https://web.archive.org/web/20150703204135/http://www.iboum.com/pr/uebo200.php,0,0,0,0,0
https://web.archive.org/web/20150703201054/http://www.iboum.com/pr/uga80.php,0,0,0,0,0
https://web.archive.org/web/20141223031627/http://www.iboum.com/pr/pipox1mk2.php,0,0,0,0,0
https://web.archive.org/web/20150703203700/http://www.iboum.com/pr/noonv9.php,0,0,0,0,0
https://web.archive.org/web/20150703193332/http://www.iboum.com/pr/riko903v.php,0,0,0,0,0
https://web.archive.org/web/20150703203144/http://www.iboum.com/pr/jesm6.php,0,0,0,0,0
https://web.archive.org/web/20141105064652/http://www.iboum.com/pr/eagetm7.php,0,0,0,0,0
https://web.archive.org/web/20150602070359/http://www.iboum.com/pr/minixnx5.php,0,0,0,0,0
https://web.archive.org/web/20150703194556/http://www.iboum.com/pr/blue1073.php,0,0,0,0,0
https://web.archive.org/web/20150703184339/http://www.iboum.com/pr/eageth5.php,0,0,0,0,0
https://web.archive.org/web/20150703195134/http://www.iboum.com/pr/geniatv200.php,0,0,0,0,0
https://web.archive.org/web/20150703204125/http://www.iboum.com/pr/bluetv1.php,0,0,0,0,0
https://web.archive.org/web/20150703204315/http://www.iboum.com/pr/FREEAG.php,0,0,0,0,0
https://web.archive.org/web/20150524055751/http://www.iboum.com/pr/xtreamsid.php,0,0,0,0,0
https://web.archive.org/web/20150703185910/http://www.iboum.com/pr/eagetx6.php,0,0,0,0,0
https://web.archive.org/web/20150703185910/http://www.iboum.com/pr/jynxm6.php,0,0,0,0,0
https://web.archive.org/web/20150703204441/http://www.iboum.com/pr/himh1.php,0,0,0,0,0
https://web.archive.org/web/20150703201434/http://www.iboum.com/pr/mic250g2.php,0,0,0,0,0
https://web.archive.org/web/20150703204320/http://www.iboum.com/pr/seagateplus.php,0,0,0,0,0
https://web.archive.org/web/20150703204431/http://www.iboum.com/pr/datprod.php,0,0,0,0,0
https://web.archive.org/web/20141104191156/http://www.iboum.com/pr/easy4mini.php,0,0,0,0,0
https://web.archive.org/web/20141220174210/http://www.iboum.com/pr/traxmmp.php,0,0,0,0,0
https://web.archive.org/web/20150703194026/http://www.iboum.com/pr/nixfs.php,0,0,0,0,0
https://web.archive.org/web/20141223031627/http://www.iboum.com/pr/dx390.php,0,0,0,0,0
https://web.archive.org/web/20150703201749/http://www.iboum.com/pr/eagetm90.php,0,0,0,0,0
https://web.archive.org/web/20150703203906/http://www.iboum.com/pr/astone100.php,0,0,0,0,0
https://web.archive.org/web/20150703204315/http://www.iboum.com/pr/pha300.php,0,0,0,0,0
https://web.archive.org/web/20150703201656/http://www.iboum.com/pr/playon-plus.php,0,0,0,0,0
https://web.archive.org/web/20150703204702/http://www.iboum.com/pr/micc350.php,0,0,0,0,0
https://web.archive.org/web/20150703195033/http://www.iboum.com/artkill/chipsets.php,0,0,0,0,0
https://web.archive.org/web/20150706170040/http://www.iboum.com/pr/tvix6500.php,0,0,0,0,0
https://web.archive.org/web/20150703185045/http://www.iboum.com/pr/conc-cm3hd.php,0,0,0,0,0
https://web.archive.org/web/20150703203721/http://www.iboum.com/pr/ugs82.php,0,0,0,0,0
https://web.archive.org/web/20150703203931/http://www.iboum.com/pr/acplayhdm.php,0,0,0,0,0
https://web.archive.org/web/20150602070359/http://www.iboum.com/pr/eagetx5.php,0,0,0,0,0
https://web.archive.org/web/20150706155444/http://www.iboum.com/pr/lgxf2.php,0,0,0,0,0
https://web.archive.org/web/20150602070359/http://www.iboum.com/pr/egreatr2a.php,0,0,0,0,0
https://web.archive.org/web/20150629215134/http://www.iboum.com/pr/enyes8.php,0,0,0,0,0
https://web.archive.org/web/20150703203229/http://www.iboum.com/pr/hi500b.php,0,0,0,0,0
https://web.archive.org/web/20150703204139/http://www.iboum.com/pr/uebo200.php,0,0,0,0,0
https://web.archive.org/web/20150703184339/http://www.iboum.com/pr/itab48r.php,0,0,0,0,0
https://web.archive.org/web/20150703195221/http://www.iboum.com/pr/blue3288.php,0,0,0,0,0
https://web.archive.org/web/20150703195050/http://www.iboum.com/pr/melem01.php,0,0,0,0,0
https://web.archive.org/web/20150703204431/http://www.iboum.com/pr/nixfs.php,0,0,0,0,0
https://web.archive.org/web/20150703193433/http://www.iboum.com/pr/minixx8p.php,0,0,0,0,0
https://web.archive.org/web/20150703201135/http://www.iboum.com/pr/mic600g2.php,0,0,0,0,0
https://web.archive.org/web/20150703204441/http://www.iboum.com/pr/dxd1.php,0,0,0,0,0
https://web.archive.org/web/20150703194556/http://www.iboum.com/pr/emtec800.php,0,0,0,0,0
https://web.archive.org/web/20150703184436/http://www.iboum.com/pr/fan2750.php,0,0,0,0,0
https://web.archive.org/web/20150524052530/http://www.iboum.com/pr/med13d.php,0,0,0,0,0
https://web.archive.org/web/20150703203534/http://www.iboum.com/pr/ferg310.php,0,0,0,0,0
https://web.archive.org/web/20150703201242/http://www.iboum.com/pr/ellion-labo.php,0,0,0,0,0
https://web.archive.org/web/20150602070359/http://www.iboum.com/pr/10m581.php,0,0,0,0,0
https://web.archive.org/web/20150602065842/http://www.iboum.com/pr/kai1055p.php,0,0,0,0,0
https://web.archive.org/web/20150524055751/http://www.iboum.com/pr/fantmini.php,0,0,0,0,0
https://web.archive.org/web/20120126140145/http://www.iboum.com/pr/icon52.php,0,0,0,0,0
https://web.archive.org/web/20150703203530/http://www.iboum.com/pr/dune103.php,0,0,0,0,0
https://web.archive.org/web/20150703192615/http://www.iboum.com/pr/brite-cinemago.php,0,0,0,0,0
https://web.archive.org/web/20141223030841/http://www.iboum.com/pr/tvix3600.php,0,0,0,0,0
https://web.archive.org/web/20141223031627/http://www.iboum.com/pr/jess82.php,0,0,0,0,0
https://web.archive.org/web/20150703195253/http://www.iboum.com/pr/itab48r.php,0,0,0,0,0
https://web.archive.org/web/20150703204441/http://www.iboum.com/pr/beem7b.php,0,0,0,0,0
https://web.archive.org/web/20150703184343/http://www.iboum.com/pr/XTREAMER.php,0,0,0,0,0
https://web.archive.org/web/20150703194138/http://www.iboum.com/pr/ugsm8.php,0,0,0,0,0
https://web.archive.org/web/20150703193925/http://www.iboum.com/pr/WDTV-MK2.php,0,0,0,0,0
https://web.archive.org/web/20150703201345/http://www.iboum.com/pr/himq54k.php,0,0,0,0,0
https://web.archive.org/web/20150703201048/http://www.iboum.com/pr/dx320.php,0,0,0,0,0
https://web.archive.org/web/20141223052656/http://www.iboum.com/pr/goto5100.php,0,0,0,0,0
https://web.archive.org/web/20150703195043/http://www.iboum.com/pr/verbmpro.php,0,0,0,0,0
https://web.archive.org/web/20150703191439/http://www.iboum.com/pr/conc-cm3hd.php,0,0,0,0,0
https://web.archive.org/web/20141223035957/http://www.iboum.com/pr/riko8023s.php,0,0,0,0,0
https://web.archive.org/web/20150703192636/http://www.iboum.com/pr/eagetm6.php,0,0,0,0,0
https://web.archive.org/web/20150703185322/http://www.iboum.com/pr/phapop3d.php,0,0,0,0,0
https://web.archive.org/web/20150703191439/http://www.iboum.com/pr/micep600.php,0,0,0,0,0
https://web.archive.org/web/20150602065712/http://www.iboum.com/pr/toms82.php,0,0,0,0,0
https://web.archive.org/web/20150703203555/http://www.iboum.com/pr/roku2xs.php,0,0,0,0,0
https://web.archive.org/web/20150703203755/http://www.iboum.com/pr/med200.php,0,0,0,0,0
https://web.archive.org/web/20150703194138/http://www.iboum.com/pr/rokuxds.php,0,0,0,0,0
https://web.archive.org/web/20150703194022/http://www.iboum.com/pr/met322.php,0,0,0,0,0
https://web.archive.org/web/20150703184343/http://www.iboum.com/pr/woxa200.php,0,0,0,0,0
https://web.archive.org/web/20150703204250/http://www.iboum.com/pr/bluemx5.php,0,0,0,0,0
https://web.archive.org/web/20150703203057/http://www.iboum.com/pr/eyef10.php,0,0,0,0,0
https://web.archive.org/web/20150703203755/http://www.iboum.com/pr/em7180.php,0,0,0,0,0
https://web.archive.org/web/20150703194022/http://www.iboum.com/pr/sumx2.php,0,0,0,0,0
https://web.archive.org/web/20150703185009/http://www.iboum.com/pr/fan3700.php,0,0,0,0,0
https://web.archive.org/web/20150703204811/http://www.iboum.com/pr/pha410x.php,0,0,0,0,0
https://web.archive.org/web/20150703184323/http://www.iboum.com/pr/myga3.php,0,0,0,0,0
https://web.archive.org/web/20150703184343/http://www.iboum.com/pr/zyxel250.php,0,0,0,0,0
https://web.archive.org/web/20150703204721/http://www.iboum.com/pr/rikoa10m.php,0,0,0,0,0
https://web.archive.org/web/20150703201345/http://www.iboum.com/pr/genia510b.php,0,0,0,0,0
https://web.archive.org/web/20150703203755/http://www.iboum.com/pr/emk220.php,0,0,0,0,0
https://web.archive.org/web/20150703192636/http://www.iboum.com/pr/exq2.php,0,0,0,0,0
https://web.archive.org/web/20150703185951/http://www.iboum.com/pr/him900a.php,0,0,0,0,0
https://web.archive.org/web/20150703192636/http://www.iboum.com/pr/geniatv1200.php,0,0,0,0,0
https://web.archive.org/web/20150703201530/http://www.iboum.com/pr/medianow101.php,0,0,0,0,0
https://web.archive.org/web/20141223025419/http://www.iboum.com/pr/howu3.php,0,0,0,0,0
https://web.archive.org/web/20150703193536/http://www.iboum.com/pr/measyu4a.php,0,0,0,0,0
https://web.archive.org/web/20150703184343/http://www.iboum.com/pr/jynxm1v2.php,0,0,0,0,0
https://web.archive.org/web/20141223041109/http://www.iboum.com/pr/probox2m.php,0,0,0,0,0
https://web.archive.org/web/20150703191458/http://www.iboum.com/pr/vissonm8.php,0,0,0,0,0
https://web.archive.org/web/20150703193536/http://www.iboum.com/artkill/network-media-players.php,0,0,0,0,0
https://web.archive.org/web/20150703185322/http://www.iboum.com/pr/iomegdx.php,0,0,0,0,0
https://web.archive.org/web/20141223052656/http://www.iboum.com/pr/micca1055.php,0,0,0,0,0
https://web.archive.org/web/20150703185322/http://www.iboum.com/pr/han01.php,0,0,0,0,0
https://web.archive.org/web/20150703201247/http://www.iboum.com/pr/acplayhdm.php,0,0,0,0,0
https://web.archive.org/web/20150703194138/http://www.iboum.com/pr/measyu2a.php,0,0,0,0,0
https://web.archive.org/web/20150703204250/http://www.iboum.com/pr/verbmpro.php,0,0,0,0,0
https://web.archive.org/web/20150703194559/http://www.iboum.com/pr/dxdroid.php,0,0,0,0,0
https://web.archive.org/web/20150703191458/http://www.iboum.com/pr/tronprom.php,0,0,0,0,0
https://web.archive.org/web/20150703204030/http://www.iboum.com/pr/pha400.php,0,0,0,0,0
https://web.archive.org/web/20150703192636/http://www.iboum.com/pr/mvult.php,0,0,0,0,0
https://web.archive.org/web/20150703191627/http://www.iboum.com/pr/hdium1.php,0,0,0,0,0
https://web.archive.org/web/20150703201345/http://www.iboum.com/pr/hornetshow.php,0,0,0,0,0
https://web.archive.org/web/20150703201345/http://www.iboum.com/pr/eaget850.php,0,0,0,0,0
https://web.archive.org/web/20150703201307/http://www.iboum.com/pr/fan2300.php,0,0,0,0,0
https://web.archive.org/web/20141223035957/http://www.iboum.com/pr/him910b.php,0,0,0,0,0
https://web.archive.org/web/20150703201048/http://www.iboum.com/pr/acfluxx.php,0,0,0,0,0
https://web.archive.org/web/20150703184323/http://www.iboum.com/pr/himq3.php,0,0,0,0,0
https://web.archive.org/web/20160728201230/http://www.iboum.com:80/pr/xtreamsid.php,0,0,0,0,0
https://web.archive.org/web/20150629182939/http://www.iboum.com/pr/howh6.php,0,0,0,0,0
https://web.archive.org/web/20150703201048/http://www.iboum.com/pr/emtecv120.php,0,0,0,0,0
https://web.archive.org/web/20150703204642/http://www.iboum.com/pr/mykam.php,0,0,0,0,0
https://web.archive.org/web/20150703203830/http://www.iboum.com/pr/popcham.php,0,0,0,0,0
https://web.archive.org/web/20150703201307/http://www.iboum.com/pr/meet01.php,0,0,0,0,0
https://web.archive.org/web/20150703203755/http://www.iboum.com/artkill/hd-audio-media-players.php,0,0,0,0,0
https://web.archive.org/web/20150703195043/http://www.iboum.com/pr/minixnx4.php,0,0,0,0,0
https://web.archive.org/web/20150703194101/http://www.iboum.com/pr/eagetx5.php,0,0,0,0,0
https://web.archive.org/web/20150703203836/mailto:mail@iboum.com,0,0,0,0,0
https://web.archive.org/web/20150602065712/http://www.iboum.com/pr/xtreamsid2.php,0,0,0,0,0
https://web.archive.org/web/20150703193925/http://www.iboum.com/pr/jes868.php,0,0,0,0,0
https://web.archive.org/web/20150703192544/http://www.iboum.com/pr/novad83.php,0,0,0,0,0
https://web.archive.org/web/20150602065712/http://www.iboum.com/pr/egreatr3a.php,0,0,0,0,0
https://web.archive.org/web/20150703204811/http://www.iboum.com/pr/him300b.php,0,0,0,0,0
https://web.archive.org/web/20150703204811/http://www.iboum.com/pr/egru5.php,0,0,0,0,0
https://web.archive.org/web/20150703191627/http://www.iboum.com/pr/bevix6030.php,0,0,0,0,0
https://web.archive.org/web/20150703184343/http://www.iboum.com/pr/ronmp40.php,0,0,0,0,0
https://web.archive.org/web/20150703192544/http://www.iboum.com/pr/apple-cloud-tv.php,0,0,0,0,0
https://web.archive.org/web/20150703201048/http://www.iboum.com/pr/him600b.php,0,0,0,0,0
https://web.archive.org/web/20150703203555/http://www.iboum.com/pr/playon.php,0,0,0,0,0
https://web.archive.org/web/20150703201545/http://www.iboum.com/pr/mygv5.php,0,0,0,0,0
https://web.archive.org/web/20141223032123/http://www.iboum.com/pr/pivxios.php,0,0,0,0,0
https://web.archive.org/web/20150703195116/http://www.iboum.com/pr/riko80.php,0,0,0,0,0
https://web.archive.org/web/20160728201230/http://www.iboum.com/pr/olevia530.php,0,0,0,0,0
https://web.archive.org/web/20150703195116/http://www.iboum.com/pr/minix6.php,0,0,0,0,0
https://web.archive.org/web/20150703191631/http://www.iboum.com/pr/bev808.php,0,0,0,0,0
https://web.archive.org/web/20150703194046/http://www.iboum.com/pr/him900b.php,0,0,0,0,0
https://web.archive.org/web/20150703204411/http://www.iboum.com/pr/noonv9.php,0,0,0,0,0
https://web.archive.org/web/20150703204632/http://www.iboum.com/pr/terr740.php,0,0,0,0,0
https://web.archive.org/web/20150703204411/http://www.iboum.com/pr/minixx8s.php,0,0,0,0,0
https://web.archive.org/web/20150705224217/http://www.iboum.com/pr/melem01.php,0,0,0,0,0
https://web.archive.org/web/20150602070111/http://www.iboum.com/pr/lgxf2.php,0,0,0,0,0
https://web.archive.org/web/20150524052820/http://www.iboum.com/pr/himq10.php,0,0,0,0,0
https://web.archive.org/web/20141223033821/http://www.iboum.com/pr/melem8.php,0,0,0,0,0
https://web.archive.org/web/20150703204350/http://www.iboum.com/pr/noonv9.php,0,0,0,0,0
https://web.archive.org/web/20150703185940/http://www.iboum.com/pr/cloudcr11.php,0,0,0,0,0
https://web.archive.org/web/20150703191631/http://www.iboum.com/pr/poppst30.php,0,0,0,0,0
https://web.archive.org/web/20151028202017/http://www.iboum.com/artkill/network-media-players.php,0,0,0,0,0
https://web.archive.org/web/20150703210610/http://www.iboum.com/pr/sunw8.php,0,0,0,0,0
https://web.archive.org/web/20150703201226/http://www.iboum.com/pr/fanttv.php,0,0,0,0,0
https://web.archive.org/web/20150524055741/http://www.iboum.com/pr/zinwell-5005.php,0,0,0,0,0
https://web.archive.org/web/20150703191631/http://www.iboum.com/pr/fan3700.php,0,0,0,0,0
https://web.archive.org/web/20150524052805/http://www.iboum.com/pr/egr6b.php,0,0,0,0,0
https://web.archive.org/web/20150703201349/http://www.iboum.com/pr/melea100b.php,0,0,0,0,0
https://web.archive.org/web/20150703185940/http://www.iboum.com/pr/ol3hd.php,0,0,0,0,0
https://web.archive.org/web/20150703194046/http://www.iboum.com/pr/nationite-hdvp1.php,0,0,0,0,0
https://web.archive.org/web/20150703203810/http://www.iboum.com/pr/blue1073.php,0,0,0,0,0
https://web.archive.org/web/20150703204204/http://www.iboum.com/pr/kai1055p.php,0,0,0,0,0
https://web.archive.org/web/20141223034716/http://www.iboum.com/pr/melem01.php,0,0,0,0,0
https://web.archive.org/web/20150703195329/http://www.iboum.com/pr/him560b.php,0,0,0,0,0
https://web.archive.org/web/20160728201230/http://www.iboum.com/pr/weopen.php,0,0,0,0,0
https://web.archive.org/web/20150703195329/http://www.iboum.com/pr/ast300t.php,0,0,0,0,0
https://web.archive.org/web/20160728201230/http://www.iboum.com/pr/em8100.php,0,0,0,0,0
https://web.archive.org/web/20150703194031/http://www.iboum.com/pr/tronv89.php,0,0,0,0,0
https://web.archive.org/web/20141223032123/http://www.iboum.com/pr/net2000live.php,0,0,0,0,0
https://web.archive.org/web/20150703201226/http://www.iboum.com/pr/micca350g2.php,0,0,0,0,0
https://web.archive.org/web/20160728201230*/http://www.iboum.com/pr/xtreamsid.php,0,0,0,0,0
https://web.archive.org/web/20150524045136/http://www.iboum.com/pr/riko8022.php,0,0,0,0,0
https://web.archive.org/web/20150703202838/http://www.iboum.com/pr/mediavx.php,0,0,0,0,0
https://web.archive.org/web/20150703201545/http://www.iboum.com/pr/ugsm8.php,0,0,0,0,0
https://web.archive.org/web/20141223033821/http://www.iboum.com/pr/dx320.php,0,0,0,0,0
https://web.archive.org/web/20150703194031/http://www.iboum.com/pr/genia310b.php,0,0,0,0,0
https://web.archive.org/web/20150703204709/http://www.iboum.com/pr/meet01.php,0,0,0,0,0
https://web.archive.org/web/20150703201349/http://www.iboum.com/pr/himq54k.php,0,0,0,0,0
https://web.archive.org/web/20150703204632/http://www.iboum.com/pr/himq52.php,0,0,0,0,0
https://web.archive.org/web/20150703203810/http://www.iboum.com/pr/kaif6000b.php,0,0,0,0,0
https://web.archive.org/web/20150703194016/http://www.iboum.com/pr/iomegplus.php,0,0,0,0,0
https://web.archive.org/web/20150703191456/http://www.iboum.com/pr/tvix6500.php,0,0,0,0,0
https://web.archive.org/web/20150703204627/http://www.iboum.com/pr/datpros.php,0,0,0,0,0
https://web.archive.org/web/20150602070111/http://www.iboum.com/pr/ferg110.php,0,0,0,0,0
https://web.archive.org/web/20150703204204/http://www.iboum.com/pr/dune-smart-d1.php,0,0,0,0,0
https://web.archive.org/web/20150703194046/http://www.iboum.com/pr/howu6.php,0,0,0,0,0
https://web.archive.org/web/20150524052820/http://www.iboum.com/pr/cloudcr13.php,0,0,0,0,0
https://web.archive.org/web/20150602070111/http://www.iboum.com/pr/realh3.php,0,0,0,0,0
https://web.archive.org/web/20150703194031/http://www.iboum.com/pr/easy4mini.php,0,0,0,0,0
https://web.archive.org/web/20150703201545/http://www.iboum.com/pr/noonv9.php,0,0,0,0,0
https://web.archive.org/web/20150703194031/http://www.iboum.com/pr/asia1.php,0,0,0,0,0
https://web.archive.org/web/20150703191606/http://www.iboum.com/pr/novad57.php,0,0,0,0,0
https://web.archive.org/web/20150705224217/http://www.iboum.com/pr/egreats2.php,0,0,0,0,0
https://web.archive.org/web/20150703202838/http://www.iboum.com/pr/geniatv120.php,0,0,0,0,0
https://web.archive.org/web/20151028202017/http://www.iboum.com/pr/haup-mvphd.php,0,0,0,0,0
https://web.archive.org/web/20150703204709/http://www.iboum.com/pr/tizzf30.php,0,0,0,0,0
https://web.archive.org/web/20150629160620/http://www.iboum.com/pr/ferg110.php,0,0,0,0,0
https://web.archive.org/web/20150703204627/http://www.iboum.com/pr/dxd1.php,0,0,0,0,0
https://web.archive.org/web/20150703210610/http://www.iboum.com/pr/egr6a2.php,0,0,0,0,0
https://web.archive.org/web/20150703191606/http://www.iboum.com/pr/sumcyclonemk2.php,0,0,0,0,0
https://web.archive.org/web/20150703191606/http://www.iboum.com/pr/datprod.php,0,0,0,0,0
https://web.archive.org/web/20150524052805/http://www.iboum.com/pr/woxter750.php,0,0,0,0,0
https://web.archive.org/web/20141223034716/http://www.iboum.com/pr/pivtofu.php,0,0,0,0,0
https://web.archive.org/web/20150703202748/http://www.iboum.com/pr/fan2300.php,0,0,0,0,0
https://web.archive.org/web/20150703201226/http://www.iboum.com/pr/jes868.php,0,0,0,0,0
https://web.archive.org/web/20150703201349/http://www.iboum.com/pr/seagoflex.php,0,0,0,0,0
https://web.archive.org/web/20150703201600/http://www.iboum.com/pr/medianow101.php,0,0,0,0,0
https://web.archive.org/web/20150703185940/http://www.iboum.com/pr/jes8093.php,0,0,0,0,0
https://web.archive.org/web/20150629160620/http://www.iboum.com/pr/bev808.php,0,0,0,0,0
https://web.archive.org/web/20150703185940/http://www.iboum.com/pr/arg335.php,0,0,0,0,0
https://web.archive.org/web/20150703191631/http://www.iboum.com/pr/melem8.php,0,0,0,0,0
https://web.archive.org/web/20150703201349/http://www.iboum.com/pr/meas8hd.php,0,0,0,0,0
https://web.archive.org/web/20150703204350/http://www.iboum.com/pr/droidmx2.php,0,0,0,0,0
https://web.archive.org/web/20141223032123/http://www.iboum.com/pr/mede8er.php,0,0,0,0,0
https://web.archive.org/web/20150703201349/http://www.iboum.com/pr/genj22d.php,0,0,0,0,0
https://web.archive.org/web/20150703202748/http://www.iboum.com/pr/bevix6030.php,0,0,0,0,0
https://web.archive.org/web/20150703201621/http://www.iboum.com/pr/netg8000.php,0,0,0,0,0
https://web.archive.org/web/20141223032123/http://www.iboum.com/pr/netg8000.php,0,0,0,0,0
https://web.archive.org/web/20150703191456/http://www.iboum.com/pr/miniz64w.php,0,0,0,0,0
https://web.archive.org/web/20141223030332/http://www.iboum.com/pr/woxa200.php,0,0,0,0,0
https://web.archive.org/web/20141223033821/http://www.iboum.com/pr/him600a.php,0,0,0,0,0
https://web.archive.org/web/20150703195116/http://www.iboum.com/pr/miccslim.php,0,0,0,0,0
https://web.archive.org/web/20150703191456/http://www.iboum.com/pr/egs800.php,0,0,0,0,0
https://web.archive.org/web/20160316185306/http://www.iboum.com/pr/howu3.php,0,0,0,0,0
https://web.archive.org/web/20150524052805/http://www.iboum.com/pr/PH200.php,0,0,0,0,0
https://web.archive.org/web/20150703201600/http://www.iboum.com/pr/dat1055.php,0,0,0,0,0
https://web.archive.org/web/20151028202017/http://www.iboum.com/pr/minixnx5.php,0,0,0,0,0
https://web.archive.org/web/20150703204709/http://www.iboum.com/pr/terr520.php,0,0,0,0,0
https://web.archive.org/web/20150703191631/http://www.iboum.com/pr/vizcostar.php,0,0,0,0,0
https://web.archive.org/web/20141223034716/http://www.iboum.com/pr/howv3.php,0,0,0,0,0
https://web.archive.org/web/20150703201600/http://www.iboum.com/pr/pipox1.php,0,0,0,0,0
https://web.archive.org/web/20150703191631/http://www.iboum.com/pr/cloudcr16.php,0,0,0,0,0
https://web.archive.org/web/20150703203810/http://www.iboum.com/pr/egr160.php,0,0,0,0,0
https://web.archive.org/web/20150703194046/http://www.iboum.com/pr/howh5.php,0,0,0,0,0
https://web.archive.org/web/20150703204204/http://www.iboum.com/pr/4gplayo.php,0,0,0,0,0
https://web.archive.org/web/20160728201230/http://www.iboum.com/pr/orbs82.php,0,0,0,0,0
https://web.archive.org/web/20150703191631/http://www.iboum.com/pr/egr12.php,0,0,0,0,0
https://web.archive.org/web/20150703203337/http://www.iboum.com/pr/fan2700.php,0,0,0,0,0
https://web.archive.org/web/20150705224217/http://www.iboum.com/pr/blue3550.php,0,0,0,0,0
https://web.archive.org/web/20150703203337/http://www.iboum.com/pr/pnip5.php,0,0,0,0,0
https://web.archive.org/web/20150703194016/http://www.iboum.com/pr/fan3700.php,0,0,0,0,0
https://web.archive.org/web/20150703204709/http://www.iboum.com/pr/novad83.php,0,0,0,0,0
https://web.archive.org/web/20150703202838/http://www.iboum.com/pr/icontsxp.php,0,0,0,0,0
https://web.archive.org/web/20150703194031/http://www.iboum.com/pr/google-tv.php,0,0,0,0,0
https://web.archive.org/web/20150705224217/http://www.iboum.com/pr/genhi702.php,0,0,0,0,0
https://web.archive.org/web/20150703204204/http://www.iboum.com/pr/kaim1073.php,0,0,0,0,0
